Si1001tracklists | 1001tracklists | [Languages]
Si1and1 | 1and1 | [Other]
Si1dot1dot1dot1 | 1dot1dot1dot1 | [Other]
Si1panel | 1panel | [Other]
Si1password | 1password | [Languages]
Si2fas | 2fas | [Other]
Si2k | 2k | [Other]
Si30secondsofcode | 30secondsofcode | [Other]
Si365datascience | 365datascience | [Other]
Si3m | 3m | [Other]
Si42 | 42 | [Other]
Si4chan | 4chan | [Other]
Si4d | 4d | [Other]
Si500px | 500px | [Other]
Si7zip | 7zip | [Other]
Si99designs | 99designs | [Other]
Si9gag | 9gag | [Other]
SiAbb | Abb | [Other]
SiAbbott | Abbott | [Other]
SiAbbvie | Abbvie | [Other]
SiAbdownloadmanager | Abdownloadmanager | [Languages]
SiAboutdotme | Aboutdotme | [Other]
SiAbstract | Abstract | [Languages]
SiAbusedotch | Abusedotch | [Other]
SiAcademia | Academia | [Other]
SiAccenture | Accenture | [Languages]
SiAccusoft | Accusoft | [Other]
SiAccuweather | Accuweather | [Languages]
SiAcer | Acer | [Languages]
SiAcm | Acm | [Other]
SiActigraph | Actigraph | [Languages]
SiActiveloop | Activeloop | [Other]
SiActivision | Activision | [Other]
SiActivitypub | Activitypub | [Other]
SiActix | Actix | [Other]
SiActualbudget | Actualbudget | [Other]
SiAcura | Acura | [Languages]
SiAda | Ada | [Other]
SiAdafruit | Adafruit | [Languages, Design]
SiAdaway | Adaway | [Other]
SiAdblock | Adblock | [Other]
SiAdblockplus | Adblockplus | [Other]
SiAddydotio | Addydotio | [Other]
SiAdguard | Adguard | [Languages]
SiAdidas | Adidas | [Other]
SiAdminer | Adminer | [Languages]
SiAdonisjs | Adonisjs | [Other]
SiAdp | Adp | [Other]
SiAdroll | Adroll | [Languages]
SiAdventofcode | Adventofcode | [Other]
SiAdyen | Adyen | [Ecommerce]
SiAegisauthenticator | Aegisauthenticator | [Languages]
SiAerlingus | Aerlingus | [Languages]
SiAeroflot | Aeroflot | [Languages]
SiAeromexico | Aeromexico | [Languages]
SiAerospike | Aerospike | [Languages]
SiAew | Aew | [Other]
SiAfdian | Afdian | [Other]
SiAffine | Affine | [Other]
SiAffinity | Affinity | [Other]
SiAffinitydesigner | Affinitydesigner | [Languages]
SiAffinityphoto | Affinityphoto | [Other]
SiAffinitypublisher | Affinitypublisher | [Languages]
SiAframe | Aframe | [Languages]
SiAfterpay | Afterpay | [Languages]
SiAftership | Aftership | [Languages]
SiAgora | Agora | [Backend, Languages]
SiAib | Aib | [Other]
SiAidungeon | Aidungeon | [Other]
SiAiohttp | Aiohttp | [Other]
SiAiqfome | Aiqfome | [Other]
SiAirasia | Airasia | [Languages]
SiAirbnb | Airbnb | [Languages]
SiAirbrake | Airbrake | [Languages]
SiAirbus | Airbus | [Languages]
SiAirbyte | Airbyte | [Languages]
SiAircall | Aircall | [Languages]
SiAircanada | Aircanada | [Languages]
SiAirchina | Airchina | [Languages]
SiAirfrance | Airfrance | [Languages]
SiAirindia | Airindia | [Languages]
SiAirplayaudio | Airplayaudio | [Languages]
SiAirplayvideo | Airplayvideo | [Languages]
SiAirserbia | Airserbia | [Languages]
SiAirtable | Airtable | [Languages]
SiAirtel | Airtel | [Languages]
SiAirtransat | Airtransat | [Languages]
SiAjv | Ajv | [Other]
SiAkamai | Akamai | [Other]
SiAkasaair | Akasaair | [Languages]
SiAkaunting | Akaunting | [Other]
SiAkiflow | Akiflow | [Other]
SiAlacritty | Alacritty | [Languages]
SiAlamy | Alamy | [Other]
SiAlbertheijn | Albertheijn | [Languages]
SiAlby | Alby | [Other]
SiAlchemy | Alchemy | [Other]
SiAldinord | Aldinord | [Languages]
SiAldisud | Aldisud | [Other]
SiAlfaromeo | Alfaromeo | [Languages]
SiAlfred | Alfred | [Languages]
SiAlgolia | Algolia | [Backend, Languages]
SiAlgorand | Algorand | [Backend, Languages]
SiAlibabacloud | Alibabacloud | [Other]
SiAlibabadotcom | Alibabadotcom | [Other]
SiAlienware | Alienware | [Languages]
SiAliexpress | Aliexpress | [Backend, Languages]
SiAlipay | Alipay | [Other]
SiAlist | Alist | [Other]
SiAllegro | Allegro | [Languages]
SiAlliedmodders | Alliedmodders | [Languages]
SiAllocine | Allocine | [Other]
SiAlltrails | Alltrails | [Backend, Languages]
SiAlmalinux | Almalinux | [DevOps, Design]
SiAlpinedotjs | Alpinedotjs | [Frontend]
SiAlpinelinux | Alpinelinux | [Frontend, DevOps, Design]
SiAlternativeto | Alternativeto | [Languages]
SiAlteryx | Alteryx | [Languages]
SiAltiumdesigner | Altiumdesigner | [Languages]
SiAlwaysdata | Alwaysdata | [Other]
SiAlx | Alx | [Other]
SiAmd | Amd | [Other]
SiAmeba | Ameba | [Other]
SiAmericanairlines | Americanairlines | [Languages]
SiAmericanexpress | Americanexpress | [Backend, Languages]
SiAmg | Amg | [Other]
SiAmp | Amp | [Other]
SiAmul | Amul | [Other]
SiAna | Ana | [Other]
SiAnaconda | Anaconda | [Other]
SiAnalogue | Analogue | [Other]
SiAndela | Andela | [Other]
SiAndroid | Android | [Languages]
SiAndroidauto | Androidauto | [Languages]
SiAndroidstudio | Androidstudio | [Languages]
SiAngular | Angular | [Frontend, Languages]
SiAnilist | Anilist | [Other]
SiAnimalplanet | Animalplanet | [Other]
SiAnimedotjs | Animedotjs | [Other]
SiAnkermake | Ankermake | [Languages]
SiAnki | Anki | [Other]
SiAnsible | Ansible | [DevOps]
SiAnswer | Answer | [Languages]
SiAnsys | Ansys | [Other]
SiAnta | Anta | [Other]
SiAntdesign | Antdesign | [Other]
SiAntena3 | Antena3 | [Other]
SiAntennapod | Antennapod | [Other]
SiAnthropic | Anthropic | [Languages, AI]
SiAntv | Antv | [Other]
SiAnycubic | Anycubic | [Other]
SiAnydesk | Anydesk | [Other]
SiAnytype | Anytype | [Other]
SiApache | Apache | [Backend]
SiApacheairflow | Apacheairflow | [Backend, Languages]
SiApacheant | Apacheant | [Backend]
SiApachecassandra | Apachecassandra | [Backend, Database, Languages]
SiApachecloudstack | Apachecloudstack | [Backend]
SiApachecordova | Apachecordova | [Backend, Languages]
SiApachecouchdb | Apachecouchdb | [Backend, Database]
SiApachedolphinscheduler | Apachedolphinscheduler | [Backend, Languages]
SiApachedoris | Apachedoris | [Backend, Languages]
SiApachedruid | Apachedruid | [Backend, Languages, Design]
SiApacheecharts | Apacheecharts | [Backend, Languages]
SiApacheflink | Apacheflink | [Backend, DevOps]
SiApachefreemarker | Apachefreemarker | [Backend, DevOps, Languages]
SiApachegroovy | Apachegroovy | [Backend, Languages]
SiApacheguacamole | Apacheguacamole | [Backend]
SiApachehadoop | Apachehadoop | [Backend]
SiApachehbase | Apachehbase | [Backend]
SiApachehive | Apachehive | [Backend]
SiApachejmeter | Apachejmeter | [Backend, Languages]
SiApachekafka | Apachekafka | [Backend]
SiApachekylin | Apachekylin | [Backend]
SiApachelucene | Apachelucene | [Backend]
SiApachemaven | Apachemaven | [Backend]
SiApachenetbeanside | Apachenetbeanside | [Backend]
SiApachenifi | Apachenifi | [Backend]
SiApacheopenoffice | Apacheopenoffice | [Backend]
SiApacheparquet | Apacheparquet | [Backend, Languages]
SiApachepulsar | Apachepulsar | [Backend, Languages]
SiApacherocketmq | Apacherocketmq | [Backend, Languages]
SiApachesolr | Apachesolr | [Backend, Languages]
SiApachespark | Apachespark | [Backend, Languages]
SiApachestorm | Apachestorm | [Backend, Languages]
SiApachesuperset | Apachesuperset | [Backend, Languages]
SiApachetomcat | Apachetomcat | [Backend]
SiAparat | Aparat | [Languages]
SiApifox | Apifox | [Other]
SiApmterminals | Apmterminals | [Languages]
SiApollographql | Apollographql | [Backend, Languages]
SiApostrophe | Apostrophe | [Languages]
SiAppgallery | Appgallery | [Languages]
SiAppian | Appian | [Other]
SiAppium | Appium | [Other]
SiApple | Apple | [Other]
SiApplearcade | Applearcade | [Languages]
SiApplemusic | Applemusic | [Other]
SiApplenews | Applenews | [Other]
SiApplepay | Applepay | [Other]
SiApplepodcasts | Applepodcasts | [Other]
SiAppletv | Appletv | [Other]
SiAppsignal | Appsignal | [Other]
SiAppsmith | Appsmith | [Other]
SiAppstore | Appstore | [Languages]
SiAppveyor | Appveyor | [Languages]
SiAppwrite | Appwrite | [Backend, Languages]
SiAqua | Aqua | [Other]
SiAral | Aral | [Languages]
SiArangodb | Arangodb | [Backend, Database, Languages]
SiArc | Arc | [Languages]
SiArcgis | Arcgis | [Languages]
SiArchicad | Archicad | [DevOps, Languages]
SiArchiveofourown | Archiveofourown | [DevOps, Languages]
SiArchlinux | Archlinux | [DevOps, Languages, Design]
SiArdour | Ardour | [Languages]
SiArduino | Arduino | [Languages, Design]
SiArgo | Argo | [Backend, Languages]
SiArgos | Argos | [Backend, Languages]
SiAriakit | Ariakit | [Languages]
SiArkecosystem | Arkecosystem | [Languages]
SiArlo | Arlo | [Languages]
SiArm | Arm | [Languages]
SiArmkeil | Armkeil | [Languages]
SiArstechnica | Arstechnica | [Languages]
SiArtifacthub | Artifacthub | [Languages]
SiArtixlinux | Artixlinux | [DevOps, Languages, Design]
SiArtstation | Artstation | [Languages]
SiArxiv | Arxiv | [Languages]
SiAsahilinux | Asahilinux | [DevOps, Design]
SiAsana | Asana | [Other]
SiAsciidoctor | Asciidoctor | [Languages]
SiAsciinema | Asciinema | [Other]
SiAsda | Asda | [Other]
SiAseprite | Aseprite | [Languages]
SiAssemblyscript | Assemblyscript | [Languages]
SiAsterisk | Asterisk | [Languages]
SiAstonmartin | Astonmartin | [Languages]
SiAstra | Astra | [Languages]
SiAstral | Astral | [Languages]
SiAstro | Astro | [Frontend, Languages]
SiAsus | Asus | [Other]
SiAtandt | Atandt | [Other]
SiAtari | Atari | [Languages]
SiAtlasos | Atlasos | [Other]
SiAtlassian | Atlassian | [Other]
SiAuchan | Auchan | [Other]
SiAudacity | Audacity | [Other]
SiAudi | Audi | [Other]
SiAudible | Audible | [Other]
SiAudiobookshelf | Audiobookshelf | [Other]
SiAudioboom | Audioboom | [Other]
SiAudiomack | Audiomack | [Other]
SiAudiotechnica | Audiotechnica | [Other]
SiAurelia | Aurelia | [Languages]
SiAuth0 | Auth0 | [Backend]
SiAuthelia | Authelia | [Other]
SiAuthentik | Authentik | [Other]
SiAuthy | Authy | [Other]
SiAutocad | Autocad | [Other]
SiAutocannon | Autocannon | [Other]
SiAutodesk | Autodesk | [Other]
SiAutodeskmaya | Autodeskmaya | [Other]
SiAutodeskrevit | Autodeskrevit | [Languages]
SiAutohotkey | Autohotkey | [Other]
SiAutoit | Autoit | [Other]
SiAutomattic | Automattic | [Other]
SiAutoprefixer | Autoprefixer | [Languages]
SiAutozone | Autozone | [Other]
SiAvajs | Avajs | [Other]
SiAvaloniaui | Avaloniaui | [Design]
SiAvast | Avast | [Other]
SiAvianca | Avianca | [Other]
SiAvira | Avira | [Languages]
SiAvm | Avm | [Other]
SiAwesomelists | Awesomelists | [Other]
SiAwesomewm | Awesomewm | [Other]
SiAwwwards | Awwwards | [Languages]
SiAxios | Axios | [Frontend]
SiAxisbank | Axisbank | [Other]
SiBabel | Babel | [Frontend]
SiBabelio | Babelio | [Frontend]
SiBabylondotjs | Babylondotjs | [Other]
SiBackblaze | Backblaze | [Other]
SiBackbone | Backbone | [Other]
SiBackbonedotjs | Backbonedotjs | [Other]
SiBackendless | Backendless | [Frontend]
SiBackstage | Backstage | [Other]
SiBackstageCasting | BackstageCasting | [Other]
SiBadoo | Badoo | [Other]
SiBaidu | Baidu | [Other]
SiBakalari | Bakalari | [Languages]
SiBamboo | Bamboo | [Other]
SiBambulab | Bambulab | [Other]
SiBandcamp | Bandcamp | [Other]
SiBandlab | Bandlab | [Other]
SiBandrautomation | Bandrautomation | [Languages]
SiBandsintown | Bandsintown | [Other]
SiBankofamerica | Bankofamerica | [Languages]
SiBarclays | Barclays | [Languages]
SiBaremetrics | Baremetrics | [Languages]
SiBarmenia | Barmenia | [Languages]
SiBasecamp | Basecamp | [Other]
SiBaserow | Baserow | [Languages]
SiBasicattentiontoken | Basicattentiontoken | [Other]
SiBastyon | Bastyon | [Other]
SiBat | Bat | [Other]
SiBata | Bata | [Other]
SiBattledotnet | Battledotnet | [Backend]
SiBazel | Bazel | [Other]
SiBeatport | Beatport | [Languages]
SiBeats | Beats | [Other]
SiBeatsbydre | Beatsbydre | [Languages]
SiBeatstars | Beatstars | [Languages]
SiBeekeeperstudio | Beekeeperstudio | [Languages]
SiBehance | Behance | [Design]
SiBeijingsubway | Beijingsubway | [Other]
SiBem | Bem | [Other]
SiBentley | Bentley | [Other]
SiBento | Bento | [Other]
SiBentobox | Bentobox | [Other]
SiBentoml | Bentoml | [Other]
SiBereal | Bereal | [Languages]
SiBetfair | Betfair | [Languages]
SiBetterauth | Betterauth | [Languages]
SiBetterdiscord | Betterdiscord | [Languages, Social]
SiBetterstack | Betterstack | [Languages]
SiBevy | Bevy | [Other]
SiBigbasket | Bigbasket | [Other]
SiBigbluebutton | Bigbluebutton | [Other]
SiBigcartel | Bigcartel | [Languages]
SiBigcommerce | Bigcommerce | [Languages, Ecommerce]
SiBilibili | Bilibili | [Other]
SiBillboard | Billboard | [Languages]
SiBim | Bim | [Other]
SiBinance | Binance | [Other]
SiBiolink | Biolink | [Other]
SiBiome | Biome | [Other]
SiBisecthosting | Bisecthosting | [Other]
SiBit | Bit | [Other]
SiBitbucket | Bitbucket | [DevOps]
SiBitcoin | Bitcoin | [Other]
SiBitcoincash | Bitcoincash | [Other]
SiBitcoinsv | Bitcoinsv | [Other]
SiBitcomet | Bitcomet | [Other]
SiBitdefender | Bitdefender | [Languages]
SiBitly | Bitly | [Other]
SiBitrise | Bitrise | [Languages]
SiBittorrent | Bittorrent | [Languages]
SiBitwarden | Bitwarden | [Languages]
SiBitwig | Bitwig | [Other]
SiBlack | Black | [Other]
SiBlackberry | Blackberry | [Languages]
SiBlackmagicdesign | Blackmagicdesign | [Other]
SiBlazemeter | Blazemeter | [Languages]
SiBlazor | Blazor | [Languages]
SiBlender | Blender | [Languages, Design]
SiBlibli | Blibli | [Other]
SiBlockbench | Blockbench | [Other]
SiBlockchaindotcom | Blockchaindotcom | [Other]
SiBlogger | Blogger | [Languages]
SiBloglovin | Bloglovin | [Other]
SiBlueprint | Blueprint | [Languages]
SiBluesky | Bluesky | [Other]
SiBluesound | Bluesound | [Other]
SiBluetooth | Bluetooth | [Other]
SiBmcsoftware | Bmcsoftware | [Languages]
SiBmw | Bmw | [Other]
SiBnbchain | Bnbchain | [Other]
SiBoardgamegeek | Boardgamegeek | [Languages]
SiBoat | Boat | [Other]
SiBoehringeringelheim | Boehringeringelheim | [Languages]
SiBoeing | Boeing | [Other]
SiBohemiainteractive | Bohemiainteractive | [Languages]
SiBombardier | Bombardier | [Languages]
SiBookalope | Bookalope | [Other]
SiBookbub | Bookbub | [Other]
SiBookingdotcom | Bookingdotcom | [Other]
SiBookmeter | Bookmeter | [Languages]
SiBookmyshow | Bookmyshow | [Other]
SiBookstack | Bookstack | [Other]
SiBoost | Boost | [Other]
SiBoosty | Boosty | [Other]
SiBoots | Boots | [Other]
SiBootstrap | Bootstrap | [Frontend, Languages]
SiBorgbackup | Borgbackup | [Languages]
SiBosch | Bosch | [Other]
SiBose | Bose | [Other]
SiBotblecms | Botblecms | [Other]
SiBoulanger | Boulanger | [Languages]
SiBower | Bower | [Languages]
SiBox | Box | [Other]
SiBoxysvg | Boxysvg | [Design]
SiBraintree | Braintree | [Languages]
SiBraintrust | Braintrust | [Backend, Languages]
SiBrandfetch | Brandfetch | [Languages]
SiBrandfolder | Brandfolder | [Languages]
SiBrave | Brave | [Languages]
SiBreaker | Breaker | [Languages]
SiBrenntag | Brenntag | [Languages]
SiBrevo | Brevo | [Languages]
SiBrex | Brex | [Languages]
SiBricks | Bricks | [Languages]
SiBritishairways | Britishairways | [Languages]
SiBroadcom | Broadcom | [Languages]
SiBruno | Bruno | [Languages]
SiBsd | Bsd | [Other]
SiBspwm | Bspwm | [Other]
SiBt | Bt | [Other]
SiBuddy | Buddy | [Other]
SiBudibase | Budibase | [Other]
SiBuefy | Buefy | [Other]
SiBuffer | Buffer | [Languages]
SiBugatti | Bugatti | [Other]
SiBugcrowd | Bugcrowd | [Languages]
SiBuhl | Buhl | [Other]
SiBuildkite | Buildkite | [Design]
SiBuiltbybit | Builtbybit | [Design]
SiBukalapak | Bukalapak | [Other]
SiBulma | Bulma | [Frontend]
SiBun | Bun | [Other]
SiBungie | Bungie | [Other]
SiBunnydotnet | Bunnydotnet | [Backend]
SiBunq | Bunq | [Other]
SiBurgerking | Burgerking | [Languages]
SiBurpsuite | Burpsuite | [Languages, Design]
SiBurton | Burton | [Languages]
SiBuymeacoffee | Buymeacoffee | [Other]
SiBuysellads | Buysellads | [Other]
SiBuzzfeed | Buzzfeed | [Other]
SiBvg | Bvg | [Other]
SiByjus | Byjus | [Other]
SiBytedance | Bytedance | [Other]
SiC | C | [Other]
SiCachet | Cachet | [Other]
SiCaddy | Caddy | [Backend]
SiCadillac | Cadillac | [Other]
SiCafepress | Cafepress | [Languages]
SiCairographics | Cairographics | [Languages]
SiCairometro | Cairometro | [Languages]
SiCaixabank | Caixabank | [Other]
SiCakephp | Cakephp | [Backend, Languages]
SiCaldotcom | Caldotcom | [Other]
SiCalendly | Calendly | [Other]
SiCalibreweb | Calibreweb | [Languages]
SiCampaignmonitor | Campaignmonitor | [Languages]
SiCamunda | Camunda | [Other]
SiCanonical | Canonical | [Other]
SiCanva | Canva | [Design]
SiCanvas | Canvas | [Design]
SiCapacitor | Capacitor | [Languages]
SiCaprover | Caprover | [Languages]
SiCardano | Cardano | [Languages]
SiCardmarket | Cardmarket | [Languages]
SiCarlsberggroup | Carlsberggroup | [Languages]
SiCarrd | Carrd | [Languages]
SiCarrefour | Carrefour | [Languages]
SiCarthrottle | Carthrottle | [Languages]
SiCarto | Carto | [Languages]
SiCashapp | Cashapp | [Other]
SiCastbox | Castbox | [Other]
SiCastorama | Castorama | [Languages]
SiCastro | Castro | [Frontend, Languages]
SiCaterpillar | Caterpillar | [Languages]
SiCbc | Cbc | [Other]
SiCbs | Cbs | [Other]
SiCcc | Ccc | [Other]
SiCcleaner | Ccleaner | [Languages]
SiCdprojekt | Cdprojekt | [Languages]
SiCe | Ce | [Other]
SiCelery | Celery | [Languages]
SiCelestron | Celestron | [Languages]
SiCentos | Centos | [DevOps]
SiCeph | Ceph | [Other]
SiCesium | Cesium | [Other]
SiChai | Chai | [Other]
SiChainguard | Chainguard | [Languages]
SiChainlink | Chainlink | [Other]
SiChakraui | Chakraui | [Frontend, Languages, Design]
SiChangedetection | Changedetection | [Other]
SiChannel4 | Channel4 | [Other]
SiCharles | Charles | [Languages]
SiChartdotjs | Chartdotjs | [Languages]
SiChartmogul | Chartmogul | [Languages]
SiChase | Chase | [Other]
SiChatbot | Chatbot | [Other]
SiChatwoot | Chatwoot | [Other]
SiCheckio | Checkio | [Other]
SiCheckmarx | Checkmarx | [Languages]
SiCheckmk | Checkmk | [Other]
SiChedraui | Chedraui | [Languages, Design]
SiCheerio | Cheerio | [Languages]
SiChef | Chef | [DevOps]
SiChemex | Chemex | [Other]
SiChessdotcom | Chessdotcom | [Other]
SiChevrolet | Chevrolet | [Languages]
SiChianetwork | Chianetwork | [Languages]
SiChinaeasternairlines | Chinaeasternairlines | [Languages]
SiChinasouthernairlines | Chinasouthernairlines | [Languages]
SiChocolatey | Chocolatey | [Other]
SiChromatic | Chromatic | [Languages]
SiChromewebstore | Chromewebstore | [Languages]
SiChrysler | Chrysler | [Languages]
SiChupachups | Chupachups | [Other]
SiCilium | Cilium | [Other]
SiCinema4d | Cinema4d | [Other]
SiCinnamon | Cinnamon | [Other]
SiCircle | Circle | [Languages]
SiCircleci | Circleci | [DevOps, Languages]
SiCircuitverse | Circuitverse | [Languages, Design]
SiCirrusci | Cirrusci | [Languages]
SiCisco | Cisco | [Other]
SiCitrix | Citrix | [Languages]
SiCitroen | Citroen | [Languages]
SiCivicrm | Civicrm | [Languages]
SiCivo | Civo | [Other]
SiClarifai | Clarifai | [Languages]
SiClaris | Claris | [Languages]
SiClarivate | Clarivate | [Languages]
SiClaude | Claude | [AI]
SiClerk | Clerk | [Backend, Languages]
SiClevercloud | Clevercloud | [Languages]
SiClickhouse | Clickhouse | [Other]
SiClickup | Clickup | [Other]
SiClion | Clion | [Other]
SiClockify | Clockify | [Other]
SiClojure | Clojure | [Languages]
SiCloud66 | Cloud66 | [Other]
SiCloudbees | Cloudbees | [Other]
SiCloudcannon | Cloudcannon | [Other]
SiCloudera | Cloudera | [Languages]
SiCloudflare | Cloudflare | [Languages]
SiCloudflarepages | Cloudflarepages | [Languages]
SiCloudflareworkers | Cloudflareworkers | [Languages]
SiCloudfoundry | Cloudfoundry | [Languages]
SiCloudinary | Cloudinary | [Languages]
SiCloudnativebuild | Cloudnativebuild | [Design]
SiCloudron | Cloudron | [Languages]
SiCloudsmith | Cloudsmith | [Other]
SiCloudways | Cloudways | [Other]
SiClubforce | Clubforce | [Languages]
SiClubhouse | Clubhouse | [Other]
SiClyp | Clyp | [Other]
SiCmake | Cmake | [Other]
SiCncf | Cncf | [Other]
SiCnes | Cnes | [Other]
SiCnet | Cnet | [Other]
SiCnn | Cnn | [Other]
SiCobalt | Cobalt | [Other]
SiCocacola | Cocacola | [Other]
SiCockpit | Cockpit | [Other]
SiCockroachlabs | Cockroachlabs | [Database, Languages]
SiCocoapods | Cocoapods | [Other]
SiCocos | Cocos | [Other]
SiCoda | Coda | [Other]
SiCodacy | Codacy | [Other]
SiCodeberg | Codeberg | [Languages]
SiCodeblocks | Codeblocks | [Other]
SiCodecademy | Codecademy | [Other]
SiCodeceptjs | Codeceptjs | [Other]
SiCodechef | Codechef | [DevOps]
SiCodeclimate | Codeclimate | [Other]
SiCodecov | Codecov | [Other]
SiCodecrafters | Codecrafters | [Languages]
SiCodefactor | Codefactor | [Languages]
SiCodeforces | Codeforces | [Languages]
SiCodefresh | Codefresh | [Languages]
SiCodeigniter | Codeigniter | [Languages]
SiCodemagic | Codemagic | [Other]
SiCodementor | Codementor | [Languages]
SiCodemirror | Codemirror | [Languages]
SiCodenewbie | Codenewbie | [Other]
SiCodepen | Codepen | [Other]
SiCodeproject | Codeproject | [Languages]
SiCoder | Coder | [Languages]
SiCoderabbit | Coderabbit | [Languages]
SiCodersrank | Codersrank | [Languages]
SiCoderwall | Coderwall | [Languages]
SiCodesandbox | Codesandbox | [Other]
SiCodeship | Codeship | [Other]
SiCodesignal | Codesignal | [Other]
SiCodestream | Codestream | [Languages]
SiCodewars | Codewars | [Languages]
SiCodingame | Codingame | [Other]
SiCodingninjas | Codingninjas | [Other]
SiCodio | Codio | [Other]
SiCoffeescript | Coffeescript | [Languages]
SiCoggle | Coggle | [Other]
SiCognizant | Cognizant | [Other]
SiCoinbase | Coinbase | [Other]
SiCoinmarketcap | Coinmarketcap | [Languages]
SiCollaboraonline | Collaboraonline | [Languages]
SiComicfury | Comicfury | [Languages]
SiComma | Comma | [Other]
SiCommerzbank | Commerzbank | [Languages]
SiCommitlint | Commitlint | [Other]
SiCommodore | Commodore | [Languages]
SiCommonlisp | Commonlisp | [Other]
SiCommonworkflowlanguage | Commonworkflowlanguage | [Languages]
SiCompilerexplorer | Compilerexplorer | [Languages]
SiComposer | Composer | [Languages]
SiComptia | Comptia | [Other]
SiComsol | Comsol | [Other]
SiConan | Conan | [Other]
SiConcourse | Concourse | [Languages]
SiCondaforge | Condaforge | [Languages]
SiConekta | Conekta | [Other]
SiConfluence | Confluence | [Other]
SiConstruct3 | Construct3 | [Languages]
SiConsul | Consul | [Other]
SiContabo | Contabo | [Other]
SiContactlesspayment | Contactlesspayment | [Frontend]
SiContainerd | Containerd | [Languages]
SiContao | Contao | [Other]
SiContentful | Contentful | [Other]
SiContentstack | Contentstack | [Other]
SiContinente | Continente | [Other]
SiContributorcovenant | Contributorcovenant | [Languages]
SiConventionalcommits | Conventionalcommits | [Other]
SiConvertio | Convertio | [Languages]
SiCookiecutter | Cookiecutter | [Languages]
SiCoolermaster | Coolermaster | [Languages]
SiCoop | Coop | [Other]
SiCopaairlines | Copaairlines | [Languages]
SiCoppel | Coppel | [Other]
SiCora | Cora | [Languages]
SiCoreldraw | Coreldraw | [Languages]
SiCoronaengine | Coronaengine | [Backend, Languages]
SiCoronarenderer | Coronarenderer | [DevOps, Languages]
SiCorsair | Corsair | [Languages]
SiCouchbase | Couchbase | [Database]
SiCounterstrike | Counterstrike | [Languages]
SiCountingworkspro | Countingworkspro | [Languages]
SiCoursera | Coursera | [Languages]
SiCoveralls | Coveralls | [Languages]
SiCoze | Coze | [Other]
SiCpanel | Cpanel | [Other]
SiCplusplus | Cplusplus | [Languages]
SiCplusplusbuilder | Cplusplusbuilder | [Languages, Design]
SiCraftcms | Craftcms | [Languages]
SiCraftsman | Craftsman | [Languages]
SiCratedb | Cratedb | [Languages]
SiCrayon | Crayon | [Languages]
SiCreality | Creality | [Frontend, Languages]
SiCreatereactapp | Createreactapp | [Frontend, Languages]
SiCreativecommons | Creativecommons | [Languages]
SiCreativetechnology | Creativetechnology | [Languages]
SiCredly | Credly | [Languages]
SiCrehana | Crehana | [Languages]
SiCrewai | Crewai | [Languages]
SiCrewunited | Crewunited | [Languages]
SiCriticalrole | Criticalrole | [Languages]
SiCrowdin | Crowdin | [Languages]
SiCrowdsource | Crowdsource | [Languages]
SiCrunchbase | Crunchbase | [Languages]
SiCrunchyroll | Crunchyroll | [Languages]
SiCryengine | Cryengine | [Backend, Languages]
SiCryptomator | Cryptomator | [Languages]
SiCryptpad | Cryptpad | [Languages]
SiCrystal | Crystal | [Languages]
SiCsdn | Csdn | [Other]
SiCss | Css | [Frontend]
SiCssdesignawards | Cssdesignawards | [Frontend, Languages]
SiCssmodules | Cssmodules | [Frontend]
SiCsswizardry | Csswizardry | [Frontend, Languages]
SiCts | Cts | [Other]
SiCucumber | Cucumber | [Languages]
SiCultura | Cultura | [Languages]
SiCurl | Curl | [Languages]
SiCurseforge | Curseforge | [Languages]
SiCustomink | Customink | [Other]
SiCyberdefenders | Cyberdefenders | [Languages]
SiCycling74 | Cycling74 | [Other]
SiCypress | Cypress | [Languages]
SiCytoscapedotjs | Cytoscapedotjs | [Other]
SiD | D | [Other]
SiD3 | D3 | [Other]
SiDacia | Dacia | [Other]
SiDaf | Daf | [Other]
SiDailydotdev | Dailydotdev | [Other]
SiDailymotion | Dailymotion | [Other]
SiDaisyui | Daisyui | [Design]
SiDapr | Dapr | [Languages]
SiDarkreader | Darkreader | [Languages]
SiDart | Dart | [Languages]
SiDarty | Darty | [Languages]
SiDaserste | Daserste | [Languages]
SiDash | Dash | [Other]
SiDashlane | Dashlane | [Other]
SiDask | Dask | [Other]
SiDassaultsystemes | Dassaultsystemes | [Other]
SiDatabricks | Databricks | [Languages]
SiDatacamp | Datacamp | [Other]
SiDatadog | Datadog | [DevOps]
SiDatadotai | Datadotai | [Other]
SiDatagrip | Datagrip | [Languages]
SiDataiku | Dataiku | [Other]
SiDatastax | Datastax | [Other]
SiDatefns | Datefns | [Other]
SiDatev | Datev | [Other]
SiDatocms | Datocms | [Other]
SiDatto | Datto | [Other]
SiDavinciresolve | Davinciresolve | [Languages]
SiDazhongdianping | Dazhongdianping | [Other]
SiDazn | Dazn | [Other]
SiDbeaver | Dbeaver | [Languages]
SiDblp | Dblp | [Other]
SiDbt | Dbt | [Other]
SiDcentertainment | Dcentertainment | [Languages]
SiDebian | Debian | [DevOps]
SiDebridlink | Debridlink | [Languages]
SiDecapcms | Decapcms | [Other]
SiDecentraland | Decentraland | [Languages]
SiDedge | Dedge | [Other]
SiDeepcool | Deepcool | [Other]
SiDeepgram | Deepgram | [Languages]
SiDeepin | Deepin | [Other]
SiDeepl | Deepl | [Other]
SiDeepmind | Deepmind | [Other]
SiDeepnote | Deepnote | [Other]
SiDeliveroo | Deliveroo | [Languages]
SiDell | Dell | [Other]
SiDelonghi | Delonghi | [Other]
SiDelphi | Delphi | [Other]
SiDelta | Delta | [Other]
SiDeluge | Deluge | [Other]
SiDeno | Deno | [Other]
SiDenon | Denon | [Other]
SiDependabot | Dependabot | [Other]
SiDependencycheck | Dependencycheck | [Other]
SiDepositphotos | Depositphotos | [Other]
SiDerspiegel | Derspiegel | [Languages]
SiDeutschebahn | Deutschebahn | [Other]
SiDeutschebank | Deutschebank | [Other]
SiDeutschepost | Deutschepost | [Other]
SiDeutschetelekom | Deutschetelekom | [Other]
SiDeutschewelle | Deutschewelle | [Other]
SiDevbox | Devbox | [Other]
SiDevdotto | Devdotto | [Other]
SiDevexpress | Devexpress | [Backend, Languages]
SiDeviantart | Deviantart | [Languages]
SiDevpost | Devpost | [Other]
SiDevrant | Devrant | [Languages]
SiDgraph | Dgraph | [Languages]
SiDhl | Dhl | [Other]
SiDiagramsdotnet | Diagramsdotnet | [Backend, Languages]
SiDialogflow | Dialogflow | [Other]
SiDiaspora | Diaspora | [Backend, Languages]
SiDictionarydotcom | Dictionarydotcom | [Languages]
SiDigg | Digg | [Other]
SiDigikeyelectronics | Digikeyelectronics | [Languages]
SiDigitalocean | Digitalocean | [DevOps]
SiDinersclub | Dinersclub | [Languages]
SiDior | Dior | [Languages]
SiDirectus | Directus | [Languages]
SiDiscogs | Discogs | [Other]
SiDiscord | Discord | [Languages, Social]
SiDiscorddotjs | Discorddotjs | [Languages, Social]
SiDiscourse | Discourse | [Languages]
SiDiscover | Discover | [Languages]
SiDisqus | Disqus | [Other]
SiDisroot | Disroot | [Languages]
SiDistrobox | Distrobox | [Languages]
SiDistrokid | Distrokid | [Languages]
SiDjango | Django | [Backend, Languages]
SiDji | Dji | [Other]
SiDlib | Dlib | [Other]
SiDlna | Dlna | [Other]
SiDm | Dm | [Other]
SiDmm | Dmm | [Other]
SiDocker | Docker | [DevOps, Languages]
SiDocsdotrs | Docsdotrs | [Languages]
SiDocsify | Docsify | [Other]
SiDoctrine | Doctrine | [Languages]
SiDocusaurus | Docusaurus | [Languages]
SiDogecoin | Dogecoin | [Other]
SiDoi | Doi | [Other]
SiDolby | Dolby | [Other]
SiDolibarr | Dolibarr | [Languages]
SiDolphin | Dolphin | [Other]
SiDoordash | Doordash | [Languages]
SiDota2 | Dota2 | [Other]
SiDotenv | Dotenv | [Other]
SiDotnet | Dotnet | [Backend]
SiDouban | Douban | [Other]
SiDoubanread | Doubanread | [Languages]
SiDovecot | Dovecot | [Other]
SiDovetail | Dovetail | [Other]
SiDowndetector | Downdetector | [Languages]
SiDoxygen | Doxygen | [Other]
SiDpd | Dpd | [Other]
SiDragonframe | Dragonframe | [Backend, Languages]
SiDraugiemdotlv | Draugiemdotlv | [Languages]
SiDreamstime | Dreamstime | [Languages]
SiDribbble | Dribbble | [Languages, Design]
SiDrizzle | Drizzle | [Languages]
SiDrone | Drone | [Languages]
SiDrooble | Drooble | [Languages]
SiDropbox | Dropbox | [Languages]
SiDrupal | Drupal | [Backend, Languages]
SiDsautomobiles | Dsautomobiles | [Other]
SiDts | Dts | [Other]
SiDtube | Dtube | [Other]
SiDucati | Ducati | [Other]
SiDuckdb | Duckdb | [Other]
SiDuckduckgo | Duckduckgo | [Backend, Languages]
SiDungeonsanddragons | Dungeonsanddragons | [Backend, Languages]
SiDunked | Dunked | [Other]
SiDunzo | Dunzo | [Other]
SiDuolingo | Duolingo | [Backend, Languages]
SiDuplicati | Duplicati | [Other]
SiDvc | Dvc | [Other]
SiDwavesystems | Dwavesystems | [Other]
SiDwm | Dwm | [Other]
SiDynatrace | Dynatrace | [Languages]
SiE | E | [Other]
SiE3 | E3 | [Other]
SiEa | Ea | [Other]
SiEac | Eac | [Other]
SiEagle | Eagle | [Other]
SiEasyeda | Easyeda | [Other]
SiEasyjet | Easyjet | [Other]
SiEbay | Ebay | [Other]
SiEbox | Ebox | [Other]
SiEclipseadoptium | Eclipseadoptium | [Other]
SiEclipseche | Eclipseche | [Other]
SiEclipseide | Eclipseide | [Other]
SiEclipsejetty | Eclipsejetty | [Other]
SiEclipsemosquitto | Eclipsemosquitto | [Design]
SiEclipsevertdotx | Eclipsevertdotx | [Languages]
SiEcosia | Ecosia | [Other]
SiEcovacs | Ecovacs | [Other]
SiEdeka | Edeka | [Other]
SiEdgeimpulse | Edgeimpulse | [Other]
SiEditorconfig | Editorconfig | [Languages]
SiEdotleclerc | Edotleclerc | [Languages]
SiEducative | Educative | [Other]
SiEdx | Edx | [Other]
SiEgghead | Egghead | [Other]
SiEgnyte | Egnyte | [Other]
SiEight | Eight | [Other]
SiEightsleep | Eightsleep | [Other]
SiEjs | Ejs | [Other]
SiElastic | Elastic | [Database]
SiElasticcloud | Elasticcloud | [Database]
SiElasticsearch | Elasticsearch | [Database, DevOps, Languages]
SiElasticstack | Elasticstack | [Database]
SiElavon | Elavon | [Other]
SiElectron | Electron | [Languages]
SiElectronbuilder | Electronbuilder | [Languages, Design]
SiElectronfiddle | Electronfiddle | [Languages]
SiElegoo | Elegoo | [Backend, Languages]
SiElement | Element | [Other]
SiElementary | Elementary | [Languages]
SiElementor | Elementor | [Languages]
SiElevenlabs | Elevenlabs | [Other]
SiEleventy | Eleventy | [Other]
SiElgato | Elgato | [Other]
SiElixir | Elixir | [Languages]
SiElm | Elm | [Other]
SiElsevier | Elsevier | [Languages]
SiEmbarcadero | Embarcadero | [Languages]
SiEmbark | Embark | [Languages]
SiEmberdotjs | Emberdotjs | [Languages]
SiEmby | Emby | [Other]
SiEmirates | Emirates | [Languages]
SiEmlakjet | Emlakjet | [Other]
SiEndeavouros | Endeavouros | [Languages]
SiEnpass | Enpass | [Other]
SiEns | Ens | [Other]
SiEnte | Ente | [Other]
SiEnterprisedb | Enterprisedb | [Languages]
SiEnvato | Envato | [Other]
SiEnvoyproxy | Envoyproxy | [Languages]
SiEpel | Epel | [Other]
SiEpicgames | Epicgames | [Other]
SiEpson | Epson | [Other]
SiEquinixmetal | Equinixmetal | [Design]
SiEraser | Eraser | [Languages]
SiEricsson | Ericsson | [Frontend, Languages]
SiErlang | Erlang | [Languages]
SiErpnext | Erpnext | [Frontend, Backend, Languages]
SiEsbuild | Esbuild | [Design]
SiEsea | Esea | [Other]
SiEslgaming | Eslgaming | [Other]
SiEslint | Eslint | [Frontend]
SiEsotericsoftware | Esotericsoftware | [Languages]
SiEsphome | Esphome | [Other]
SiEspressif | Espressif | [Languages]
SiEsri | Esri | [Languages]
SiEtcd | Etcd | [Other]
SiEthereum | Ethereum | [Languages]
SiEthers | Ethers | [Languages]
SiEthiopianairlines | Ethiopianairlines | [Languages]
SiEtihadairways | Etihadairways | [Languages]
SiEtsy | Etsy | [Other]
SiEuropeanunion | Europeanunion | [Languages]
SiEventstore | Eventstore | [Languages]
SiEvernote | Evernote | [Languages]
SiEverydotorg | Everydotorg | [Languages]
SiExcalidraw | Excalidraw | [Languages]
SiExercism | Exercism | [Languages]
SiExordo | Exordo | [Languages]
SiExoscale | Exoscale | [Other]
SiExpedia | Expedia | [Other]
SiExpensify | Expensify | [Other]
SiExpertsexchange | Expertsexchange | [Languages]
SiExpo | Expo | [Other]
SiExpress | Express | [Backend, Languages]
SiExpressdotcom | Expressdotcom | [Backend, Languages]
SiExpressvpn | Expressvpn | [Backend, Languages]
SiEyeem | Eyeem | [Other]
SiF1 | F1 | [Other]
SiF5 | F5 | [Other]
SiFacebook | Facebook | [Social]
SiFacebookgaming | Facebookgaming | [Social]
SiFacebooklive | Facebooklive | [Social]
SiFaceit | Faceit | [Other]
SiFacepunch | Facepunch | [Other]
SiFairphone | Fairphone | [Languages]
SiFalco | Falco | [Other]
SiFalcon | Falcon | [Other]
SiFampay | Fampay | [Other]
SiFandango | Fandango | [Backend, Languages]
SiFandom | Fandom | [Frontend]
SiFanfou | Fanfou | [Other]
SiFantom | Fantom | [Other]
SiFarcaster | Farcaster | [Languages]
SiFareharbor | Fareharbor | [Languages]
SiFarfetch | Farfetch | [Languages]
SiFastapi | Fastapi | [Backend]
SiFastify | Fastify | [Backend]
SiFastlane | Fastlane | [Other]
SiFastly | Fastly | [Other]
SiFathom | Fathom | [Other]
SiFauna | Fauna | [Database]
SiFavro | Favro | [Languages]
SiFcc | Fcc | [Other]
SiFdroid | Fdroid | [Languages]
SiFedex | Fedex | [Other]
SiFedora | Fedora | [DevOps, Languages]
SiFeedly | Feedly | [Other]
SiFerrari | Ferrari | [Languages]
SiFerrarinv | Ferrarinv | [Languages]
SiFerretdb | Ferretdb | [Languages]
SiFfmpeg | Ffmpeg | [Other]
SiFi | Fi | [Other]
SiFiat | Fiat | [Other]
SiFidoalliance | Fidoalliance | [Other]
SiFifa | Fifa | [Other]
SiFig | Fig | [Other]
SiFigma | Figma | [Design]
SiFigshare | Figshare | [Languages]
SiFila | Fila | [Other]
SiFilament | Filament | [Other]
SiFiledotio | Filedotio | [Other]
SiFilen | Filen | [Other]
SiFiles | Files | [Other]
SiFilezilla | Filezilla | [Other]
SiFineco | Fineco | [Other]
SiFing | Fing | [Other]
SiFirebase | Firebase | [Backend, Database, Languages]
SiFirefish | Firefish | [Languages]
SiFireflyiii | Fireflyiii | [Languages]
SiFirefox | Firefox | [Languages]
SiFirefoxbrowser | Firefoxbrowser | [Languages]
SiFireship | Fireship | [Languages]
SiFirewalla | Firewalla | [Languages]
SiFirst | First | [Languages]
SiFishshell | Fishshell | [Languages]
SiFitbit | Fitbit | [Other]
SiFivem | Fivem | [Other]
SiFiverr | Fiverr | [Languages]
SiFizz | Fizz | [Other]
SiFlashforge | Flashforge | [Languages]
SiFlask | Flask | [Backend]
SiFlat | Flat | [Other]
SiFlathub | Flathub | [Other]
SiFlatpak | Flatpak | [Other]
SiFlickr | Flickr | [Languages]
SiFlightaware | Flightaware | [Languages]
SiFlipboard | Flipboard | [Languages]
SiFlipkart | Flipkart | [Languages]
SiFloatplane | Floatplane | [Other]
SiFlood | Flood | [Other]
SiFloorp | Floorp | [Languages]
SiFluentbit | Fluentbit | [Other]
SiFluentd | Fluentd | [Other]
SiFluke | Fluke | [Other]
SiFlutter | Flutter | [Languages]
SiFlux | Flux | [Design]
SiFlydotio | Flydotio | [Other]
SiFlyway | Flyway | [Other]
SiFmod | Fmod | [Other]
SiFnac | Fnac | [Other]
SiFolium | Folium | [Other]
SiFolo | Folo | [Other]
SiFonoma | Fonoma | [Other]
SiFontawesome | Fontawesome | [Other]
SiFontbase | Fontbase | [Other]
SiFontforge | Fontforge | [Languages]
SiFoobar2000 | Foobar2000 | [Languages]
SiFoodpanda | Foodpanda | [Other]
SiFord | Ford | [Languages]
SiForgejo | Forgejo | [Languages]
SiFormbricks | Formbricks | [Languages]
SiFormik | Formik | [Frontend, Languages]
SiFormspree | Formspree | [Languages]
SiFormstack | Formstack | [Languages]
SiFortinet | Fortinet | [Languages]
SiFortnite | Fortnite | [Languages]
SiFortran | Fortran | [Languages]
SiFossa | Fossa | [Other]
SiFossilscm | Fossilscm | [Other]
SiFoundryvirtualtabletop | Foundryvirtualtabletop | [Languages]
SiFoursquare | Foursquare | [Languages, Ecommerce]
SiFox | Fox | [Other]
SiFoxtel | Foxtel | [Other]
SiFozzy | Fozzy | [Other]
SiFramer | Framer | [Frontend, Languages, Design]
SiFramework | Framework | [Languages]
SiFramework7 | Framework7 | [Languages]
SiFranprix | Franprix | [Languages]
SiFrappe | Frappe | [Languages]
SiFraunhofergesellschaft | Fraunhofergesellschaft | [Languages]
SiFreebsd | Freebsd | [Languages]
SiFreecad | Freecad | [Languages]
SiFreecodecamp | Freecodecamp | [Languages]
SiFreedesktopdotorg | Freedesktopdotorg | [Languages]
SiFreelancer | Freelancer | [Languages]
SiFreelancermap | Freelancermap | [Languages]
SiFreenas | Freenas | [Languages]
SiFreenet | Freenet | [Languages]
SiFreepik | Freepik | [Languages]
SiFreetube | Freetube | [Languages]
SiFresh | Fresh | [Languages]
SiFreshrss | Freshrss | [Languages]
SiFrigate | Frigate | [Languages]
SiFritz | Fritz | [Languages]
SiFrontendmentor | Frontendmentor | [Languages]
SiFrontify | Frontify | [Languages]
SiFsharp | Fsharp | [Languages]
SiFubo | Fubo | [Other]
SiFueler | Fueler | [Languages]
SiFugacloud | Fugacloud | [Other]
SiFujifilm | Fujifilm | [Other]
SiFujitsu | Fujitsu | [Other]
SiFuraffinity | Furaffinity | [Languages]
SiFurrynetwork | Furrynetwork | [Languages]
SiFusionauth | Fusionauth | [Other]
SiFuturelearn | Futurelearn | [Languages]
SiFyle | Fyle | [Other]
SiG2 | G2 | [Other]
SiG2a | G2a | [Other]
SiG2g | G2g | [Other]
SiGalaxus | Galaxus | [Other]
SiGamebanana | Gamebanana | [Other]
SiGamedeveloper | Gamedeveloper | [Languages]
SiGamejolt | Gamejolt | [Other]
SiGameloft | Gameloft | [Other]
SiGamemaker | Gamemaker | [Languages]
SiGamescience | Gamescience | [Other]
SiGandi | Gandi | [Other]
SiGarmin | Garmin | [Languages]
SiGarudalinux | Garudalinux | [DevOps, Languages, Design]
SiGatling | Gatling | [Other]
SiGatsby | Gatsby | [Frontend]
SiGcore | Gcore | [Languages]
SiGdal | Gdal | [Other]
SiGeeksforgeeks | Geeksforgeeks | [Languages]
SiGeneralelectric | Generalelectric | [Languages]
SiGeneralmotors | Generalmotors | [Languages]
SiGenius | Genius | [Other]
SiGentoo | Gentoo | [Other]
SiGeocaching | Geocaching | [Other]
SiGeode | Geode | [Other]
SiGeopandas | Geopandas | [AI]
SiGerrit | Gerrit | [Languages]
SiGetx | Getx | [Other]
SiGhost | Ghost | [Backend]
SiGhostery | Ghostery | [Backend, Languages]
SiGimp | Gimp | [Design]
SiGin | Gin | [Backend]
SiGiphy | Giphy | [Other]
SiGit | Git | [DevOps]
SiGitbook | Gitbook | [DevOps]
SiGitcode | Gitcode | [DevOps]
SiGitconnected | Gitconnected | [DevOps]
SiGitea | Gitea | [DevOps]
SiGitee | Gitee | [DevOps]
SiGitextensions | Gitextensions | [DevOps]
SiGitforwindows | Gitforwindows | [DevOps, Languages]
SiGithub | Github | [DevOps]
SiGithubactions | Githubactions | [DevOps]
SiGithubcopilot | Githubcopilot | [DevOps, AI]
SiGithubpages | Githubpages | [DevOps]
SiGithubsponsors | Githubsponsors | [DevOps, Languages]
SiGitignoredotio | Gitignoredotio | [DevOps, Languages]
SiGitkraken | Gitkraken | [DevOps, Languages]
SiGitlab | Gitlab | [DevOps]
SiGitlfs | Gitlfs | [DevOps]
SiGitpod | Gitpod | [DevOps]
SiGitter | Gitter | [DevOps, Languages]
SiGlassdoor | Glassdoor | [Languages]
SiGldotinet | Gldotinet | [Other]
SiGleam | Gleam | [Other]
SiGlide | Glide | [Other]
SiGlitch | Glitch | [Frontend]
SiGlobus | Globus | [Other]
SiGlovo | Glovo | [Other]
SiGltf | Gltf | [Other]
SiGmail | Gmail | [Other]
SiGmx | Gmx | [Other]
SiGnome | Gnome | [Other]
SiGnometerminal | Gnometerminal | [Languages]
SiGnu | Gnu | [Other]
SiGnubash | Gnubash | [DevOps, Languages]
SiGnuemacs | Gnuemacs | [Other]
SiGnuicecat | Gnuicecat | [Design]
SiGnuprivacyguard | Gnuprivacyguard | [Languages]
SiGnusocial | Gnusocial | [Other]
SiGo | Go | [Backend, Languages]
SiGocd | Gocd | [Backend, Languages]
SiGodaddy | Godaddy | [Backend, Languages]
SiGodotengine | Godotengine | [Backend, Languages, Design]
SiGofundme | Gofundme | [Backend, Languages]
SiGogdotcom | Gogdotcom | [Backend, Languages]
SiGojek | Gojek | [Backend, Languages]
SiGoland | Goland | [Backend, Languages]
SiGoldmansachs | Goldmansachs | [Backend, Languages]
SiGoodreads | Goodreads | [Backend, Languages]
SiGoogle | Google | [Backend, Languages]
SiGoogleadmob | Googleadmob | [Backend, Languages]
SiGoogleads | Googleads | [Backend, Languages]
SiGoogleadsense | Googleadsense | [Backend, Languages]
SiGoogleanalytics | Googleanalytics | [Backend, Languages]
SiGoogleappsscript | Googleappsscript | [Backend, Languages]
SiGoogleassistant | Googleassistant | [Backend, Languages]
SiGoogleauthenticator | Googleauthenticator | [Backend, Languages]
SiGooglebigquery | Googlebigquery | [Backend, Database, Languages]
SiGooglebigtable | Googlebigtable | [Backend, Languages]
SiGooglecalendar | Googlecalendar | [Backend, Languages]
SiGooglecampaignmanager360 | Googlecampaignmanager360 | [Backend, Languages]
SiGooglecardboard | Googlecardboard | [Backend, Languages]
SiGooglecast | Googlecast | [Backend, Languages]
SiGooglechat | Googlechat | [Backend, Languages]
SiGooglechrome | Googlechrome | [Backend, Languages]
SiGooglechronicle | Googlechronicle | [Backend, Languages]
SiGoogleclassroom | Googleclassroom | [Backend, Languages]
SiGooglecloud | Googlecloud | [Backend, DevOps, Languages]
SiGooglecloudcomposer | Googlecloudcomposer | [Backend, DevOps, Languages]
SiGooglecloudspanner | Googlecloudspanner | [Backend, DevOps, Languages]
SiGooglecloudstorage | Googlecloudstorage | [Backend, DevOps, Languages]
SiGooglecolab | Googlecolab | [Backend, Languages]
SiGooglecontaineroptimizedos | Googlecontaineroptimizedos | [Backend, Languages]
SiGoogledataflow | Googledataflow | [Backend, Languages]
SiGoogledataproc | Googledataproc | [Backend, Languages]
SiGoogledisplayandvideo360 | Googledisplayandvideo360 | [Backend, Languages]
SiGoogledocs | Googledocs | [Backend, Languages]
SiGoogledrive | Googledrive | [Backend, Languages]
SiGoogleearth | Googleearth | [Backend, Languages]
SiGoogleearthengine | Googleearthengine | [Backend, Languages]
SiGooglefit | Googlefit | [Backend, Languages]
SiGooglefonts | Googlefonts | [Backend, Languages]
SiGoogleforms | Googleforms | [Backend, Languages]
SiGooglegemini | Googlegemini | [Backend, Languages]
SiGooglehome | Googlehome | [Backend, Languages]
SiGooglekeep | Googlekeep | [Backend, Languages]
SiGooglelens | Googlelens | [Backend, Languages]
SiGooglemaps | Googlemaps | [Backend, Languages]
SiGooglemarketingplatform | Googlemarketingplatform | [Backend, Languages]
SiGooglemeet | Googlemeet | [Backend, Languages]
SiGooglemessages | Googlemessages | [Backend, Languages]
SiGooglenearby | Googlenearby | [Backend, Languages]
SiGooglenews | Googlenews | [Backend, Languages]
SiGooglepay | Googlepay | [Backend, Languages]
SiGooglephotos | Googlephotos | [Backend, Languages]
SiGoogleplay | Googleplay | [Backend, Languages]
SiGooglepubsub | Googlepubsub | [Backend, Languages]
SiGooglescholar | Googlescholar | [Backend, Languages]
SiGooglesearchconsole | Googlesearchconsole | [Backend, DevOps, Languages]
SiGooglesheets | Googlesheets | [Backend, Languages]
SiGoogleslides | Googleslides | [Backend, Languages]
SiGooglestreetview | Googlestreetview | [Backend, Languages]
SiGooglesummerofcode | Googlesummerofcode | [Backend, Languages]
SiGoogletagmanager | Googletagmanager | [Backend, Languages]
SiGoogletasks | Googletasks | [Backend, Languages]
SiGoogletranslate | Googletranslate | [Backend, Languages]
SiGoogletv | Googletv | [Backend, Languages]
SiGotomeeting | Gotomeeting | [Backend, Languages]
SiGplv3 | Gplv3 | [Other]
SiGrab | Grab | [Languages]
SiGradio | Gradio | [Languages]
SiGradle | Gradle | [Languages]
SiGradleplaypublisher | Gradleplaypublisher | [Languages]
SiGrafana | Grafana | [DevOps, Languages]
SiGrammarly | Grammarly | [Languages]
SiGrandfrais | Grandfrais | [Languages]
SiGrapheneos | Grapheneos | [Languages]
SiGraphite | Graphite | [Languages]
SiGraphql | Graphql | [Backend, Languages]
SiGrav | Grav | [Languages]
SiGravatar | Gravatar | [Languages]
SiGraylog | Graylog | [Languages]
SiGreasyfork | Greasyfork | [Languages]
SiGreatlearning | Greatlearning | [Languages]
SiGreenhouse | Greenhouse | [Languages]
SiGreensock | Greensock | [Languages]
SiGreptimedb | Greptimedb | [Languages]
SiGriddotai | Griddotai | [Languages]
SiGridsome | Gridsome | [Languages]
SiGrocy | Grocy | [Languages]
SiGroupme | Groupme | [Languages]
SiGroupon | Groupon | [Languages]
SiGrunt | Grunt | [Languages]
SiGsap | Gsap | [Other]
SiGsk | Gsk | [Other]
SiGsma | Gsma | [Other]
SiGsmarenadotcom | Gsmarenadotcom | [Languages]
SiGstreamer | Gstreamer | [Languages]
SiGtk | Gtk | [Other]
SiGuangzhoumetro | Guangzhoumetro | [Languages]
SiGuilded | Guilded | [Design]
SiGuitarpro | Guitarpro | [Languages, Design]
SiGulp | Gulp | [Other]
SiGumroad | Gumroad | [Languages, Ecommerce]
SiGumtree | Gumtree | [Languages]
SiGunicorn | Gunicorn | [Languages]
SiGurobi | Gurobi | [Languages]
SiGusto | Gusto | [Other]
SiGutenberg | Gutenberg | [Languages]
SiH2database | H2database | [Other]
SiH3 | H3 | [Other]
SiHabr | Habr | [Languages]
SiHackaday | Hackaday | [Other]
SiHackclub | Hackclub | [Other]
SiHackerearth | Hackerearth | [Languages]
SiHackernoon | Hackernoon | [Languages]
SiHackerone | Hackerone | [Languages]
SiHackerrank | Hackerrank | [Languages]
SiHackster | Hackster | [Languages]
SiHackthebox | Hackthebox | [Other]
SiHal | Hal | [Other]
SiHandlebarsdotjs | Handlebarsdotjs | [Languages]
SiHandm | Handm | [Other]
SiHandshake | Handshake | [Other]
SiHandshakeProtocol | HandshakeProtocol | [Languages]
SiHappycow | Happycow | [Other]
SiHarbor | Harbor | [Languages]
SiHarmonyos | Harmonyos | [Languages]
SiHashicorp | Hashicorp | [Languages]
SiHashnode | Hashnode | [Backend]
SiHaskell | Haskell | [Languages]
SiHasura | Hasura | [Languages]
SiHatenabookmark | Hatenabookmark | [Languages]
SiHaveibeenpwned | Haveibeenpwned | [Other]
SiHavells | Havells | [Other]
SiHaxe | Haxe | [Other]
SiHaystack | Haystack | [Other]
SiHbo | Hbo | [Other]
SiHbomax | Hbomax | [Other]
SiHcl | Hcl | [Other]
SiHdfcbank | Hdfcbank | [Other]
SiHeadlessui | Headlessui | [Frontend, Design]
SiHeadphonezone | Headphonezone | [Other]
SiHeadspace | Headspace | [Other]
SiHearth | Hearth | [Languages]
SiHearthisdotat | Hearthisdotat | [Languages]
SiHedera | Hedera | [Languages]
SiHedgedoc | Hedgedoc | [Other]
SiHelium | Helium | [Other]
SiHelix | Helix | [Other]
SiHellofresh | Hellofresh | [Languages]
SiHellyhansen | Hellyhansen | [Other]
SiHelm | Helm | [DevOps]
SiHelpdesk | Helpdesk | [Other]
SiHelpscout | Helpscout | [Other]
SiHepsiemlak | Hepsiemlak | [Other]
SiHere | Here | [Languages]
SiHermes | Hermes | [Languages]
SiHeroicgameslauncher | Heroicgameslauncher | [Languages]
SiHeroku | Heroku | [DevOps, Languages]
SiHeroui | Heroui | [Languages, Design]
SiHetzner | Hetzner | [Languages]
SiHevy | Hevy | [Other]
SiHexlet | Hexlet | [Other]
SiHexo | Hexo | [Other]
SiHey | Hey | [Other]
SiHibernate | Hibernate | [Languages]
SiHibob | Hibob | [Other]
SiHilton | Hilton | [Other]
SiHiltonhotelsandresorts | Hiltonhotelsandresorts | [Languages]
SiHitachi | Hitachi | [Other]
SiHive | Hive | [Other]
SiHiveBlockchain | HiveBlockchain | [Other]
SiHivemq | Hivemq | [Other]
SiHomarr | Homarr | [Languages]
SiHomeadvisor | Homeadvisor | [Languages]
SiHomeassistant | Homeassistant | [Other]
SiHomeassistantcommunitystore | Homeassistantcommunitystore | [Languages, Design]
SiHomebrew | Homebrew | [Languages]
SiHomebridge | Homebridge | [Languages]
SiHomepage | Homepage | [Other]
SiHomify | Homify | [Other]
SiHonda | Honda | [Other]
SiHoney | Honey | [Other]
SiHoneybadger | Honeybadger | [Languages]
SiHoneygain | Honeygain | [Other]
SiHono | Hono | [Other]
SiHonor | Honor | [Languages]
SiHootsuite | Hootsuite | [Design]
SiHoppscotch | Hoppscotch | [Other]
SiHostinger | Hostinger | [Languages]
SiHotelsdotcom | Hotelsdotcom | [Other]
SiHotjar | Hotjar | [Languages]
SiHotwire | Hotwire | [Languages]
SiHoudini | Houdini | [Other]
SiHouzz | Houzz | [Other]
SiHp | Hp | [Other]
SiHsbc | Hsbc | [Other]
SiHtc | Htc | [Other]
SiHtcvive | Htcvive | [Other]
SiHtml5 | Html5 | [Frontend]
SiHtmlacademy | Htmlacademy | [Frontend]
SiHtmx | Htmx | [Other]
SiHtop | Htop | [Other]
SiHttpie | Httpie | [Other]
SiHuawei | Huawei | [Other]
SiHubspot | Hubspot | [Other]
SiHuggingface | Huggingface | [Backend, AI]
SiHugo | Hugo | [Backend, Languages]
SiHumblebundle | Humblebundle | [Other]
SiHumhub | Humhub | [Other]
SiHungryjacks | Hungryjacks | [Languages]
SiHusqvarna | Husqvarna | [Languages]
SiHyper | Hyper | [Languages]
SiHyperskill | Hyperskill | [Languages]
SiHyperx | Hyperx | [Languages]
SiHypothesis | Hypothesis | [Other]
SiHyprland | Hyprland | [Languages]
SiHyundai | Hyundai | [Other]
SiI18next | I18next | [Frontend, Backend]
SiI3 | I3 | [Other]
SiIata | Iata | [Other]
SiIbeacon | Ibeacon | [Other]
SiIberia | Iberia | [Languages]
SiIced | Iced | [Other]
SiIceland | Iceland | [Other]
SiIcicibank | Icicibank | [Other]
SiIcinga | Icinga | [Other]
SiIcloud | Icloud | [Other]
SiIcomoon | Icomoon | [Other]
SiIcon | Icon | [Other]
SiIconfinder | Iconfinder | [Languages]
SiIconify | Iconify | [Other]
SiIconjar | Iconjar | [Languages]
SiIcons8 | Icons8 | [Other]
SiIcq | Icq | [Other]
SiIeee | Ieee | [Other]
SiIfixit | Ifixit | [Other]
SiIfood | Ifood | [Other]
SiIfttt | Ifttt | [Other]
SiIgdb | Igdb | [Other]
SiIgn | Ign | [Other]
SiIheartradio | Iheartradio | [Languages]
SiIkea | Ikea | [Other]
SiIledefrancemobilites | Iledefrancemobilites | [Frontend, Languages]
SiIlovepdf | Ilovepdf | [Other]
SiImagedotsc | Imagedotsc | [Other]
SiImagej | Imagej | [Other]
SiImdb | Imdb | [Other]
SiImessage | Imessage | [Other]
SiImgur | Imgur | [Languages]
SiImmer | Immer | [Languages]
SiImmersivetranslate | Immersivetranslate | [Languages]
SiImmich | Immich | [Other]
SiImou | Imou | [Other]
SiImprovmx | Improvmx | [Languages]
SiIndeed | Indeed | [Other]
SiIndiansuperleague | Indiansuperleague | [Languages]
SiIndiehackers | Indiehackers | [Languages]
SiIndigo | Indigo | [Backend, Languages]
SiInductiveautomation | Inductiveautomation | [Other]
SiInertia | Inertia | [Languages]
SiInfiniti | Infiniti | [Other]
SiInfinityfree | Infinityfree | [Languages]
SiInfluxdb | Influxdb | [Database, Design]
SiInfomaniak | Infomaniak | [Other]
SiInfoq | Infoq | [Other]
SiInformatica | Informatica | [Languages]
SiInfosys | Infosys | [Other]
SiInfracost | Infracost | [Languages]
SiIngress | Ingress | [Languages]
SiInkdrop | Inkdrop | [Languages]
SiInkscape | Inkscape | [Design]
SiInoreader | Inoreader | [Languages]
SiInquirer | Inquirer | [Languages, Design]
SiInsomnia | Insomnia | [Other]
SiInspire | Inspire | [Languages]
SiInsta360 | Insta360 | [Other]
SiInstacart | Instacart | [Languages]
SiInstagram | Instagram | [Languages, Social]
SiInstapaper | Instapaper | [Languages]
SiInstatus | Instatus | [Other]
SiInstructables | Instructables | [Languages]
SiInstructure | Instructure | [Languages]
SiIntel | Intel | [Other]
SiIntellijidea | Intellijidea | [Other]
SiInteractiondesignfoundation | Interactiondesignfoundation | [Frontend, Languages]
SiInteractjs | Interactjs | [Languages]
SiInterbase | Interbase | [Languages]
SiIntercom | Intercom | [Languages]
SiIntermarche | Intermarche | [DevOps, Languages]
SiInternetarchive | Internetarchive | [DevOps, Languages]
SiInternetcomputer | Internetcomputer | [Languages]
SiIntigriti | Intigriti | [Languages]
SiIntuit | Intuit | [Design]
SiInvidious | Invidious | [Other]
SiInvision | Invision | [Design]
SiInvoiceninja | Invoiceninja | [Other]
SiIobroker | Iobroker | [Languages]
SiIonic | Ionic | [Other]
SiIonos | Ionos | [Other]
SiIos | Ios | [Other]
SiIota | Iota | [Other]
SiIpfs | Ipfs | [Other]
SiIris | Iris | [Languages]
SiIrobot | Irobot | [Languages]
SiIsc2 | Isc2 | [Other]
SiIsro | Isro | [Languages]
SiIssuu | Issuu | [Other]
SiIstio | Istio | [Other]
SiItchdotio | Itchdotio | [Other]
SiIterm2 | Iterm2 | [Languages]
SiItunes | Itunes | [Other]
SiItvx | Itvx | [Other]
SiIveco | Iveco | [Other]
SiJabber | Jabber | [Languages]
SiJaeger | Jaeger | [Languages]
SiJaguar | Jaguar | [Languages]
SiJameson | Jameson | [Other]
SiJamstack | Jamstack | [Frontend]
SiJapanairlines | Japanairlines | [Languages]
SiJasmine | Jasmine | [Other]
SiJavascript | Javascript | [Frontend, Backend, Languages]
SiJbl | Jbl | [Other]
SiJcb | Jcb | [Other]
SiJdoodle | Jdoodle | [Other]
SiJeep | Jeep | [Other]
SiJekyll | Jekyll | [Other]
SiJellyfin | Jellyfin | [Other]
SiJenkins | Jenkins | [DevOps]
SiJest | Jest | [Other]
SiJet | Jet | [Other]
SiJetblue | Jetblue | [Other]
SiJetbrains | Jetbrains | [Languages]
SiJetpackcompose | Jetpackcompose | [Other]
SiJfrog | Jfrog | [Languages]
SiJfrogpipelines | Jfrogpipelines | [Languages]
SiJhipster | Jhipster | [Languages]
SiJinja | Jinja | [Other]
SiJio | Jio | [Other]
SiJira | Jira | [Languages]
SiJirasoftware | Jirasoftware | [Languages]
SiJitpack | Jitpack | [Other]
SiJitsi | Jitsi | [Other]
SiJohndeere | Johndeere | [Languages]
SiJoomla | Joomla | [Other]
SiJoplin | Joplin | [Other]
SiJordan | Jordan | [Languages]
SiJouav | Jouav | [Other]
SiJovian | Jovian | [Other]
SiJpeg | Jpeg | [Other]
SiJquery | Jquery | [Frontend, Languages]
SiJrgroup | Jrgroup | [Languages]
SiJsdelivr | Jsdelivr | [Languages]
SiJsfiddle | Jsfiddle | [Other]
SiJson | Json | [Other]
SiJsonwebtokens | Jsonwebtokens | [Other]
SiJsr | Jsr | [Languages]
SiJss | Jss | [Other]
SiJuce | Juce | [Other]
SiJuejin | Juejin | [Other]
SiJuke | Juke | [Other]
SiJulia | Julia | [Languages]
SiJunipernetworks | Junipernetworks | [Languages]
SiJunit5 | Junit5 | [Other]
SiJupyter | Jupyter | [Languages, AI]
SiJusteat | Justeat | [Other]
SiJustgiving | Justgiving | [Other]
SiK3s | K3s | [Other]
SiK6 | K6 | [Other]
SiKaggle | Kaggle | [AI]
SiKagi | Kagi | [Other]
SiKahoot | Kahoot | [Other]
SiKaios | Kaios | [Other]
SiKakao | Kakao | [Other]
SiKakaotalk | Kakaotalk | [Other]
SiKalilinux | Kalilinux | [DevOps, Design]
SiKamailio | Kamailio | [Other]
SiKaniko | Kaniko | [Other]
SiKarlsruherverkehrsverbund | Karlsruherverkehrsverbund | [Languages]
SiKasasmart | Kasasmart | [Languages]
SiKashflow | Kashflow | [Other]
SiKaspersky | Kaspersky | [Backend, Languages]
SiKatana | Katana | [Other]
SiKaufland | Kaufland | [Other]
SiKde | Kde | [Other]
SiKdeneon | Kdeneon | [Database]
SiKdenlive | Kdenlive | [Other]
SiKdeplasma | Kdeplasma | [Other]
SiKedro | Kedro | [Languages]
SiKeenetic | Keenetic | [Other]
SiKeepachangelog | Keepachangelog | [Other]
SiKeepassxc | Keepassxc | [Other]
SiKeeper | Keeper | [Languages]
SiKeeweb | Keeweb | [Other]
SiKenmei | Kenmei | [Other]
SiKentico | Kentico | [Other]
SiKeploy | Keploy | [Other]
SiKeras | Keras | [Languages, AI]
SiKeybase | Keybase | [Other]
SiKeycdn | Keycdn | [Other]
SiKeycloak | Keycloak | [Other]
SiKeystone | Keystone | [Other]
SiKfc | Kfc | [Other]
SiKhanacademy | Khanacademy | [Other]
SiKhronosgroup | Khronosgroup | [Languages]
SiKia | Kia | [Other]
SiKibana | Kibana | [Other]
SiKicad | Kicad | [Other]
SiKick | Kick | [Other]
SiKickstarter | Kickstarter | [Languages]
SiKik | Kik | [Other]
SiKingstontechnology | Kingstontechnology | [Other]
SiKinopoisk | Kinopoisk | [Other]
SiKinsta | Kinsta | [Other]
SiKirby | Kirby | [Languages]
SiKit | Kit | [Other]
SiKitsu | Kitsu | [Other]
SiKiwix | Kiwix | [Other]
SiKlarna | Klarna | [Languages, Ecommerce]
SiKleinanzeigen | Kleinanzeigen | [Other]
SiKlm | Klm | [Other]
SiKlook | Klook | [Other]
SiKnative | Knative | [Other]
SiKnexdotjs | Knexdotjs | [Other]
SiKnime | Knime | [Other]
SiKnip | Knip | [Other]
SiKnowledgebase | Knowledgebase | [Other]
SiKnown | Known | [Other]
SiKoa | Koa | [Backend]
SiKoc | Koc | [Other]
SiKodak | Kodak | [Other]
SiKodi | Kodi | [Other]
SiKoenigsegg | Koenigsegg | [Other]
SiKofax | Kofax | [Other]
SiKofi | Kofi | [Other]
SiKomoot | Komoot | [Other]
SiKonami | Konami | [Other]
SiKong | Kong | [Other]
SiKongregate | Kongregate | [Languages]
SiKonva | Konva | [Other]
SiKoreader | Koreader | [Languages]
SiKotlin | Kotlin | [Languages]
SiKoyeb | Koyeb | [Other]
SiKred | Kred | [Languages]
SiKrita | Krita | [Languages]
SiKtm | Ktm | [Other]
SiKtor | Ktor | [Languages]
SiKuaishou | Kuaishou | [Other]
SiKubernetes | Kubernetes | [DevOps, Languages]
SiKubespray | Kubespray | [Languages]
SiKubuntu | Kubuntu | [DevOps]
SiKucoin | Kucoin | [Other]
SiKueski | Kueski | [Other]
SiKuma | Kuma | [Other]
SiKununu | Kununu | [Other]
SiKuula | Kuula | [Other]
SiKx | Kx | [Other]
SiKyocera | Kyocera | [Languages]
SiLabview | Labview | [Other]
SiLada | Lada | [Other]
SiLamborghini | Lamborghini | [Languages]
SiLandrover | Landrover | [Languages]
SiLangchain | Langchain | [AI]
SiLangflow | Langflow | [Other]
SiLanggraph | Langgraph | [Languages]
SiLanguagetool | Languagetool | [Other]
SiLapce | Lapce | [Other]
SiLaragon | Laragon | [Backend, Languages]
SiLaravel | Laravel | [Backend, Languages]
SiLaravelhorizon | Laravelhorizon | [Backend, Languages]
SiLaravelnova | Laravelnova | [Backend, Languages]
SiLastdotfm | Lastdotfm | [Other]
SiLastpass | Lastpass | [Other]
SiLatex | Latex | [Other]
SiLaunchpad | Launchpad | [Other]
SiLazarus | Lazarus | [Languages]
SiLazyvim | Lazyvim | [Other]
SiLbry | Lbry | [Languages]
SiLeaderprice | Leaderprice | [Languages]
SiLeaflet | Leaflet | [Other]
SiLeagueoflegends | Leagueoflegends | [Other]
SiLeanpub | Leanpub | [Other]
SiLeetcode | Leetcode | [Other]
SiLefthook | Lefthook | [Other]
SiLegacygames | Legacygames | [Other]
SiLeica | Leica | [Other]
SiLemmy | Lemmy | [Other]
SiLemonsqueezy | Lemonsqueezy | [Other]
SiLenovo | Lenovo | [Other]
SiLens | Lens | [Other]
SiLeptos | Leptos | [Other]
SiLequipe | Lequipe | [Design]
SiLerna | Lerna | [Languages]
SiLeroymerlin | Leroymerlin | [Languages]
SiLeslibraires | Leslibraires | [Languages]
SiLess | Less | [Frontend]
SiLetsencrypt | Letsencrypt | [Languages]
SiLetterboxd | Letterboxd | [Languages]
SiLevelsdotfyi | Levelsdotfyi | [Other]
SiLg | Lg | [Other]
SiLiberadotchat | Liberadotchat | [Languages]
SiLiberapay | Liberapay | [Languages]
SiLibrariesdotio | Librariesdotio | [Languages]
SiLibrarything | Librarything | [Languages]
SiLibreoffice | Libreoffice | [Languages]
SiLibreofficebase | Libreofficebase | [Languages]
SiLibreofficecalc | Libreofficecalc | [Languages]
SiLibreofficedraw | Libreofficedraw | [Languages]
SiLibreofficeimpress | Libreofficeimpress | [Languages]
SiLibreofficemath | Libreofficemath | [Languages]
SiLibreofficewriter | Libreofficewriter | [Languages]
SiLibretranslate | Libretranslate | [Languages]
SiLibretube | Libretube | [Languages]
SiLibrewolf | Librewolf | [Languages]
SiLibuv | Libuv | [Other]
SiLichess | Lichess | [Other]
SiLidl | Lidl | [Other]
SiLifx | Lifx | [Other]
SiLightburn | Lightburn | [Languages]
SiLighthouse | Lighthouse | [Other]
SiLightning | Lightning | [Other]
SiLimesurvey | Limesurvey | [Languages]
SiLine | Line | [Other]
SiLineageos | Lineageos | [Other]
SiLinear | Linear | [Languages]
SiLining | Lining | [Other]
SiLinkerd | Linkerd | [Languages]
SiLinkfire | Linkfire | [Languages]
SiLinksys | Linksys | [Other]
SiLinktree | Linktree | [Languages]
SiLinphone | Linphone | [Other]
SiLintcode | Lintcode | [Other]
SiLinux | Linux | [DevOps, Design]
SiLinuxcontainers | Linuxcontainers | [DevOps, Languages, Design]
SiLinuxfoundation | Linuxfoundation | [Frontend, DevOps, Design]
SiLinuxmint | Linuxmint | [DevOps, Design]
SiLinuxprofessionalinstitute | Linuxprofessionalinstitute | [DevOps, Languages, Design]
SiLinuxserver | Linuxserver | [DevOps, Languages, Design]
SiLionair | Lionair | [Languages]
SiLiquibase | Liquibase | [Design]
SiListmonk | Listmonk | [Other]
SiLit | Lit | [Frontend]
SiLitecoin | Litecoin | [Frontend]
SiLiteral | Literal | [Frontend, Languages]
SiLitiengine | Litiengine | [Frontend, Backend]
SiLivechat | Livechat | [Other]
SiLivejournal | Livejournal | [Languages]
SiLivekit | Livekit | [Other]
SiLivewire | Livewire | [Languages]
SiLlvm | Llvm | [Other]
SiLmms | Lmms | [Other]
SiLobsters | Lobsters | [Languages]
SiLocal | Local | [Other]
SiLocalsend | Localsend | [Other]
SiLocalxpose | Localxpose | [Other]
SiLodash | Lodash | [Other]
SiLogitech | Logitech | [DevOps]
SiLogitechg | Logitechg | [DevOps]
SiLogmein | Logmein | [Other]
SiLogseq | Logseq | [Other]
SiLogstash | Logstash | [Other]
SiLooker | Looker | [Languages]
SiLoom | Loom | [Other]
SiLoop | Loop | [Other]
SiLoopback | Loopback | [Other]
SiLootcrate | Lootcrate | [Languages]
SiLospec | Lospec | [Other]
SiLotpolishairlines | Lotpolishairlines | [Languages]
SiLottiefiles | Lottiefiles | [Other]
SiLtspice | Ltspice | [Other]
SiLua | Lua | [Languages]
SiLuau | Luau | [Languages]
SiLubuntu | Lubuntu | [DevOps]
SiLucia | Lucia | [Other]
SiLucid | Lucid | [Other]
SiLucide | Lucide | [Other]
SiLudwig | Ludwig | [Other]
SiLufthansa | Lufthansa | [Other]
SiLumen | Lumen | [Other]
SiLunacy | Lunacy | [Other]
SiLutris | Lutris | [Languages]
SiLvgl | Lvgl | [Other]
SiLydia | Lydia | [Other]
SiLyft | Lyft | [Other]
SiMaas | Maas | [Other]
SiMacos | Macos | [Other]
SiMacpaw | Macpaw | [Other]
SiMacports | Macports | [Languages]
SiMacys | Macys | [Other]
SiMagasinsu | Magasinsu | [Other]
SiMagic | Magic | [Other]
SiMagisk | Magisk | [Other]
SiMahindra | Mahindra | [Languages]
SiMailboxdotorg | Mailboxdotorg | [Languages]
SiMailchimp | Mailchimp | [Other]
SiMaildotcom | Maildotcom | [Other]
SiMaildotru | Maildotru | [Languages]
SiMailgun | Mailgun | [Other]
SiMailtrap | Mailtrap | [Languages]
SiMainwp | Mainwp | [Other]
SiMajorleaguehacking | Majorleaguehacking | [Languages]
SiMake | Make | [Other]
SiMakerbot | Makerbot | [Languages]
SiMalt | Malt | [Other]
SiMalwarebytes | Malwarebytes | [Languages]
SiMambaui | Mambaui | [Design]
SiMamp | Mamp | [Other]
SiMan | Man | [Other]
SiManageiq | Manageiq | [Other]
SiMangaupdates | Mangaupdates | [Other]
SiManjaro | Manjaro | [Languages]
SiMantine | Mantine | [Other]
SiMapbox | Mapbox | [Other]
SiMapillary | Mapillary | [Languages]
SiMaplibre | Maplibre | [Languages]
SiMaptiler | Maptiler | [Languages]
SiMariadb | Mariadb | [Database, Languages]
SiMariadbfoundation | Mariadbfoundation | [Frontend, Database, Languages]
SiMarkdown | Markdown | [Languages]
SiMarko | Marko | [Languages]
SiMarriott | Marriott | [Languages]
SiMarvelapp | Marvelapp | [Languages]
SiMaserati | Maserati | [Languages]
SiMastercard | Mastercard | [Languages]
SiMastercomfig | Mastercomfig | [Languages]
SiMastodon | Mastodon | [Other]
SiMaterialdesign | Materialdesign | [Languages]
SiMaterialdesignicons | Materialdesignicons | [Languages]
SiMaterialformkdocs | Materialformkdocs | [Languages]
SiMatillion | Matillion | [Other]
SiMatomo | Matomo | [Other]
SiMatrix | Matrix | [Languages]
SiMatterdotjs | Matterdotjs | [Languages]
SiMattermost | Mattermost | [Languages]
SiMatternet | Matternet | [Languages]
SiMautic | Mautic | [Other]
SiMax | Max | [Other]
SiMaxplanckgesellschaft | Maxplanckgesellschaft | [Other]
SiMaytag | Maytag | [Other]
SiMazda | Mazda | [Other]
SiMaze | Maze | [Other]
SiMcafee | Mcafee | [Other]
SiMcdonalds | Mcdonalds | [Other]
SiMclaren | Mclaren | [Languages]
SiMdbook | Mdbook | [Other]
SiMdnwebdocs | Mdnwebdocs | [Other]
SiMdx | Mdx | [Other]
SiMealie | Mealie | [Other]
SiMediafire | Mediafire | [Languages]
SiMediamarkt | Mediamarkt | [Languages]
SiMediapipe | Mediapipe | [Other]
SiMediatek | Mediatek | [Other]
SiMedibangpaint | Medibangpaint | [Other]
SiMedium | Medium | [Other]
SiMedusa | Medusa | [Other]
SiMeetup | Meetup | [Other]
SiMega | Mega | [Other]
SiMeilisearch | Meilisearch | [DevOps, Languages]
SiMeituan | Meituan | [Other]
SiMeizu | Meizu | [Other]
SiMendeley | Mendeley | [Other]
SiMentorcruise | Mentorcruise | [Languages, Design]
SiMercadopago | Mercadopago | [Backend, Languages]
SiMerck | Merck | [Languages]
SiMercurial | Mercurial | [Languages]
SiMermaid | Mermaid | [Languages]
SiMessenger | Messenger | [Languages, Social]
SiMeta | Meta | [Other]
SiMetabase | Metabase | [Other]
SiMetacritic | Metacritic | [Languages]
SiMetafilter | Metafilter | [Languages]
SiMetager | Metager | [Languages]
SiMetasploit | Metasploit | [Backend]
SiMeteor | Meteor | [Languages]
SiMetro | Metro | [Languages]
SiMetrodelaciudaddemexico | Metrodelaciudaddemexico | [Languages]
SiMetrodemadrid | Metrodemadrid | [Languages]
SiMetrodeparis | Metrodeparis | [Languages]
SiMewe | Mewe | [Other]
SiMezmo | Mezmo | [Other]
SiMg | Mg | [Other]
SiMicrobit | Microbit | [Languages]
SiMicrodotblog | Microdotblog | [Languages]
SiMicroeditor | Microeditor | [Languages]
SiMicropython | Micropython | [Backend, Languages]
SiMicrostation | Microstation | [Languages]
SiMicrostrategy | Microstrategy | [Languages]
SiMidi | Midi | [Other]
SiMigadu | Migadu | [Other]
SiMihon | Mihon | [Other]
SiMihoyo | Mihoyo | [Other]
SiMikrotik | Mikrotik | [Languages]
SiMilanote | Milanote | [Other]
SiMilvus | Milvus | [Other]
SiMinds | Minds | [Other]
SiMinetest | Minetest | [Other]
SiMingww64 | Mingww64 | [Other]
SiMini | Mini | [Other]
SiMinio | Minio | [Other]
SiMintlify | Mintlify | [Other]
SiMinutemailer | Minutemailer | [Languages]
SiMiraheze | Miraheze | [Languages]
SiMiro | Miro | [Languages]
SiMisskey | Misskey | [Other]
SiMistralai | Mistralai | [Languages]
SiMitsubishi | Mitsubishi | [Other]
SiMix | Mix | [Other]
SiMixcloud | Mixcloud | [Other]
SiMixpanel | Mixpanel | [Other]
SiMlb | Mlb | [Other]
SiMlflow | Mlflow | [Other]
SiMobx | Mobx | [Other]
SiMobxstatetree | Mobxstatetree | [Languages]
SiMocha | Mocha | [Other]
SiMockserviceworker | Mockserviceworker | [Languages]
SiModal | Modal | [Other]
SiModelcontextprotocol | Modelcontextprotocol | [Languages]
SiModin | Modin | [Other]
SiModrinth | Modrinth | [Languages]
SiModx | Modx | [Other]
SiMojeek | Mojeek | [Other]
SiMoleculer | Moleculer | [Languages]
SiMomenteo | Momenteo | [Other]
SiMonero | Monero | [Languages]
SiMoneygram | Moneygram | [Languages]
SiMongodb | Mongodb | [Backend, Database, Languages]
SiMongoose | Mongoose | [Backend, Database, Languages]
SiMongoosedotws | Mongoosedotws | [Backend, Database, Languages]
SiMonica | Monica | [Other]
SiMonkeytie | Monkeytie | [Other]
SiMonkeytype | Monkeytype | [Other]
SiMonogame | Monogame | [Other]
SiMonoprix | Monoprix | [Languages]
SiMonster | Monster | [Languages]
SiMonzo | Monzo | [Other]
SiMoo | Moo | [Other]
SiMoodle | Moodle | [Other]
SiMoonrepo | Moonrepo | [Languages]
SiMoq | Moq | [Other]
SiMoqups | Moqups | [Other]
SiMorrisons | Morrisons | [Languages]
SiMoscowmetro | Moscowmetro | [Languages]
SiMotorola | Motorola | [Languages]
SiMovistar | Movistar | [Languages]
SiMozilla | Mozilla | [Other]
SiMpv | Mpv | [Other]
SiMqtt | Mqtt | [Other]
SiMsi | Msi | [Other]
SiMsibusiness | Msibusiness | [Other]
SiMta | Mta | [Other]
SiMtr | Mtr | [Languages]
SiMubi | Mubi | [Other]
SiMui | Mui | [Frontend, Design]
SiMulesoft | Mulesoft | [Other]
SiMuller | Muller | [Languages]
SiMullvad | Mullvad | [Other]
SiMultisim | Multisim | [Other]
SiMumble | Mumble | [Other]
SiMuo | Muo | [Other]
SiMural | Mural | [Languages]
SiMusescore | Musescore | [Languages]
SiMusicbrainz | Musicbrainz | [Languages]
SiMxlinux | Mxlinux | [DevOps, Design]
SiMyanimelist | Myanimelist | [Other]
SiMyget | Myget | [Other]
SiMyob | Myob | [Other]
SiMyshows | Myshows | [Other]
SiMyspace | Myspace | [Other]
SiMysql | Mysql | [Database]
SiN26 | N26 | [Other]
SiN8n | N8n | [Other]
SiNamebase | Namebase | [Other]
SiNamecheap | Namecheap | [Other]
SiNamemc | Namemc | [Other]
SiNamesilo | Namesilo | [Other]
SiNamuwiki | Namuwiki | [Other]
SiNano | Nano | [Other]
SiNanostores | Nanostores | [Languages]
SiNapster | Napster | [Languages]
SiNasa | Nasa | [Other]
SiNationalgrid | Nationalgrid | [Languages]
SiNationalrail | Nationalrail | [Languages]
SiNativescript | Nativescript | [Languages]
SiNatsdotio | Natsdotio | [Other]
SiNaver | Naver | [Languages]
SiNba | Nba | [Other]
SiNbb | Nbb | [Other]
SiNbc | Nbc | [Other]
SiNdr | Ndr | [Languages]
SiNear | Near | [Languages]
SiNebula | Nebula | [Other]
SiNec | Nec | [Other]
SiNederlandsespoorwegen | Nederlandsespoorwegen | [Languages]
SiNeo4j | Neo4j | [Database]
SiNeovim | Neovim | [Other]
SiNeptune | Neptune | [Other]
SiNestjs | Nestjs | [Backend]
SiNetapp | Netapp | [Other]
SiNetbsd | Netbsd | [Other]
SiNetcup | Netcup | [Other]
SiNetdata | Netdata | [Other]
SiNeteasecloudmusic | Neteasecloudmusic | [Other]
SiNetflix | Netflix | [Other]
SiNetgear | Netgear | [Languages]
SiNetim | Netim | [Other]
SiNetlify | Netlify | [DevOps]
SiNette | Nette | [Other]
SiNetto | Netto | [Other]
SiNeutralinojs | Neutralinojs | [Languages]
SiNewbalance | Newbalance | [Other]
SiNewegg | Newegg | [Other]
SiNewjapanprowrestling | Newjapanprowrestling | [Languages]
SiNewpipe | Newpipe | [Other]
SiNewrelic | Newrelic | [DevOps, Languages]
SiNewyorktimes | Newyorktimes | [Languages]
SiNexon | Nexon | [Other]
SiNextbike | Nextbike | [Frontend, Backend]
SiNextbilliondotai | Nextbilliondotai | [Frontend, Backend]
SiNextcloud | Nextcloud | [Frontend, Backend]
SiNextdns | Nextdns | [Frontend, Backend]
SiNextdoor | Nextdoor | [Frontend, Backend, Languages]
SiNextdotjs | Nextdotjs | [Frontend, Backend]
SiNextflow | Nextflow | [Frontend, Backend]
SiNextra | Nextra | [Frontend, Backend, Languages]
SiNexusmods | Nexusmods | [Other]
SiNfc | Nfc | [Other]
SiNfcore | Nfcore | [Languages]
SiNginx | Nginx | [Backend]
SiNginxproxymanager | Nginxproxymanager | [Backend, Languages]
SiNgrok | Ngrok | [Languages]
SiNgrx | Ngrx | [Languages]
SiNhl | Nhl | [Other]
SiNhost | Nhost | [Other]
SiNicehash | Nicehash | [Other]
SiNiconico | Niconico | [Other]
SiNike | Nike | [Other]
SiNikon | Nikon | [Other]
SiNim | Nim | [Other]
SiNissan | Nissan | [Other]
SiNixos | Nixos | [DevOps]
SiNobaralinux | Nobaralinux | [DevOps, Languages, Design]
SiNodebb | Nodebb | [Backend]
SiNodedotjs | Nodedotjs | [Backend]
SiNodemon | Nodemon | [Backend]
SiNodered | Nodered | [Backend, Languages]
SiNokia | Nokia | [Other]
SiNomad | Nomad | [Other]
SiNorco | Norco | [Languages]
SiNordicsemiconductor | Nordicsemiconductor | [Languages]
SiNordvpn | Nordvpn | [Languages]
SiNormalizedotcss | Normalizedotcss | [Frontend, Languages]
SiNorton | Norton | [Languages]
SiNorwegian | Norwegian | [Languages]
SiNote | Note | [Other]
SiNotebooklm | Notebooklm | [Other]
SiNotepadplusplus | Notepadplusplus | [Other]
SiNotion | Notion | [Other]
SiNotist | Notist | [Other]
SiNounproject | Nounproject | [Languages]
SiNovu | Novu | [Other]
SiNow | Now | [Other]
SiNpm | Npm | [Other]
SiNrwl | Nrwl | [Languages]
SiNsis | Nsis | [Other]
SiNtfy | Ntfy | [Other]
SiNubank | Nubank | [Other]
SiNucleo | Nucleo | [Other]
SiNuget | Nuget | [Other]
SiNuke | Nuke | [Other]
SiNumba | Numba | [Other]
SiNumpy | Numpy | [AI]
SiNunjucks | Nunjucks | [Other]
SiNushell | Nushell | [Languages]
SiNutanix | Nutanix | [Other]
SiNuxt | Nuxt | [Frontend, Backend, Design]
SiNvidia | Nvidia | [Other]
SiNvm | Nvm | [Other]
SiNx | Nx | [Other]
SiNxp | Nxp | [Other]
SiNzxt | Nzxt | [Other]
SiO2 | O2 | [Other]
SiObb | Obb | [Other]
SiObservable | Observable | [Languages]
SiObsidian | Obsidian | [Other]
SiObsstudio | Obsstudio | [Other]
SiObtainium | Obtainium | [Other]
SiOcaml | Ocaml | [Other]
SiOclc | Oclc | [Other]
SiOclif | Oclif | [Other]
SiOctanerender | Octanerender | [DevOps, Languages]
SiOctave | Octave | [Other]
SiOctobercms | Octobercms | [Languages]
SiOctoprint | Octoprint | [Languages]
SiOctopusdeploy | Octopusdeploy | [Other]
SiOculus | Oculus | [Other]
SiOdin | Odin | [Other]
SiOdnoklassniki | Odnoklassniki | [Other]
SiOdoo | Odoo | [Other]
SiOdysee | Odysee | [Other]
SiOhdear | Ohdear | [Languages]
SiOkcupid | Okcupid | [Other]
SiOkta | Okta | [Other]
SiOkx | Okx | [Other]
SiOllama | Ollama | [AI]
SiOmadacloud | Omadacloud | [Other]
SiOneplus | Oneplus | [Other]
SiOnestream | Onestream | [Backend, Languages]
SiOnlyfans | Onlyfans | [Other]
SiOnlyoffice | Onlyoffice | [Other]
SiOnnx | Onnx | [Other]
SiOnstar | Onstar | [Languages]
SiOpel | Opel | [Other]
SiOpen3d | Open3d | [Other]
SiOpenaccess | Openaccess | [Other]
SiOpenai | Openai | [AI]
SiOpenaigym | Openaigym | [AI]
SiOpenapiinitiative | Openapiinitiative | [Other]
SiOpenbadges | Openbadges | [Other]
SiOpenbsd | Openbsd | [Other]
SiOpenbugbounty | Openbugbounty | [Other]
SiOpencollective | Opencollective | [Other]
SiOpencontainersinitiative | Opencontainersinitiative | [Languages]
SiOpencritic | Opencritic | [Languages]
SiOpencv | Opencv | [Other]
SiOpenfaas | Openfaas | [Other]
SiOpengl | Opengl | [Other]
SiOpenhab | Openhab | [Other]
SiOpenid | Openid | [Other]
SiOpenjdk | Openjdk | [Other]
SiOpenjsfoundation | Openjsfoundation | [Frontend]
SiOpenlayers | Openlayers | [Languages]
SiOpenmediavault | Openmediavault | [Other]
SiOpenmined | Openmined | [Other]
SiOpennebula | Opennebula | [Other]
SiOpenproject | Openproject | [Languages]
SiOpenscad | Openscad | [Other]
SiOpensea | Opensea | [Other]
SiOpensearch | Opensearch | [DevOps, Languages]
SiOpensourcehardware | Opensourcehardware | [Languages]
SiOpensourceinitiative | Opensourceinitiative | [Languages]
SiOpenssl | Openssl | [Other]
SiOpenstack | Openstack | [Other]
SiOpenstreetmap | Openstreetmap | [Languages]
SiOpensuse | Opensuse | [Other]
SiOpentelemetry | Opentelemetry | [Languages]
SiOpentext | Opentext | [Other]
SiOpentofu | Opentofu | [Other]
SiOpenverse | Openverse | [Languages]
SiOpenvpn | Openvpn | [Other]
SiOpenwrt | Openwrt | [Languages]
SiOpenzeppelin | Openzeppelin | [Other]
SiOpenzfs | Openzfs | [Other]
SiOpera | Opera | [Languages]
SiOperagx | Operagx | [Languages]
SiOpnsense | Opnsense | [Other]
SiOppo | Oppo | [Other]
SiOpsgenie | Opsgenie | [Other]
SiOpslevel | Opslevel | [Other]
SiOptimism | Optimism | [Other]
SiOptuna | Optuna | [Other]
SiOrange | Orange | [Languages]
SiOrcid | Orcid | [Languages]
SiOreilly | Oreilly | [Languages]
SiOrg | Org | [Languages]
SiOrganicmaps | Organicmaps | [Languages]
SiOrigin | Origin | [Backend, Languages]
SiOsano | Osano | [Other]
SiOsf | Osf | [Other]
SiOsgeo | Osgeo | [Other]
SiOshkosh | Oshkosh | [Other]
SiOsmand | Osmand | [Other]
SiOsmc | Osmc | [Other]
SiOsu | Osu | [Other]
SiOtto | Otto | [Other]
SiOutline | Outline | [Other]
SiOvercast | Overcast | [Languages]
SiOverleaf | Overleaf | [Languages]
SiOvh | Ovh | [Other]
SiOwasp | Owasp | [Backend]
SiOwncloud | Owncloud | [Other]
SiOxc | Oxc | [Other]
SiOxygen | Oxygen | [Other]
SiOyo | Oyo | [Other]
SiP5dotjs | P5dotjs | [Other]
SiPackagist | Packagist | [Other]
SiPacker | Packer | [Languages]
SiPackt | Packt | [Other]
SiPaddle | Paddle | [Other]
SiPaddlepaddle | Paddlepaddle | [Other]
SiPaddypower | Paddypower | [Languages]
SiPadlet | Padlet | [Other]
SiPagekit | Pagekit | [Other]
SiPagerduty | Pagerduty | [Languages]
SiPagespeedinsights | Pagespeedinsights | [Other]
SiPagseguro | Pagseguro | [Languages]
SiPalantir | Palantir | [Languages]
SiPaloaltonetworks | Paloaltonetworks | [Languages]
SiPaloaltosoftware | Paloaltosoftware | [Languages]
SiPanasonic | Panasonic | [Other]
SiPandas | Pandas | [AI]
SiPandora | Pandora | [Languages]
SiPantheon | Pantheon | [Other]
SiPaperlessngx | Paperlessngx | [Frontend, Languages]
SiPaperspace | Paperspace | [Languages]
SiPaperswithcode | Paperswithcode | [Languages]
SiParadoxinteractive | Paradoxinteractive | [Languages]
SiParamountplus | Paramountplus | [Languages]
SiParitysubstrate | Paritysubstrate | [Languages]
SiParrotsecurity | Parrotsecurity | [Languages]
SiParsedotly | Parsedotly | [Languages]
SiPassport | Passport | [Languages]
SiPastebin | Pastebin | [Other]
SiPatreon | Patreon | [Languages]
SiPayback | Payback | [Other]
SiPaychex | Paychex | [Other]
SiPayhip | Payhip | [Other]
SiPayloadcms | Payloadcms | [Other]
SiPayoneer | Payoneer | [Languages]
SiPaypal | Paypal | [Ecommerce]
SiPaysafe | Paysafe | [Other]
SiPaytm | Paytm | [Other]
SiPcgamingwiki | Pcgamingwiki | [Other]
SiPdm | Pdm | [Other]
SiPdq | Pdq | [Other]
SiPeakdesign | Peakdesign | [Other]
SiPearson | Pearson | [Languages]
SiPeerlist | Peerlist | [Languages]
SiPeertube | Peertube | [Languages]
SiPegasusairlines | Pegasusairlines | [Languages]
SiPelican | Pelican | [Other]
SiPeloton | Peloton | [Other]
SiPenny | Penny | [Other]
SiPenpot | Penpot | [Other]
SiPercy | Percy | [Languages]
SiPerforce | Perforce | [Languages]
SiPerl | Perl | [Languages]
SiPerplexity | Perplexity | [Languages]
SiPersistent | Persistent | [Languages]
SiPersonio | Personio | [Languages]
SiPetsathome | Petsathome | [Other]
SiPeugeot | Peugeot | [Other]
SiPexels | Pexels | [Other]
SiPfsense | Pfsense | [Other]
SiPhabricator | Phabricator | [Languages]
SiPhilipshue | Philipshue | [Other]
SiPhoenixframework | Phoenixframework | [Backend, Languages]
SiPhonepe | Phonepe | [Other]
SiPhosphoricons | Phosphoricons | [Languages]
SiPhotobucket | Photobucket | [Other]
SiPhotocrowd | Photocrowd | [Languages]
SiPhoton | Photon | [Other]
SiPhotopea | Photopea | [Other]
SiPhp | Php | [Backend, Languages]
SiPhpbb | Phpbb | [Backend, Languages]
SiPhpmyadmin | Phpmyadmin | [Backend, Languages]
SiPhpstorm | Phpstorm | [Backend, Languages]
SiPiaggiogroup | Piaggiogroup | [Languages]
SiPiapro | Piapro | [Languages]
SiPicardsurgeles | Picardsurgeles | [Languages]
SiPicartodottv | Picartodottv | [Languages]
SiPicnic | Picnic | [Other]
SiPicpay | Picpay | [Other]
SiPicrew | Picrew | [Languages]
SiPicsart | Picsart | [Languages]
SiPicxy | Picxy | [Other]
SiPihole | Pihole | [Other]
SiPimcore | Pimcore | [Languages]
SiPinboard | Pinboard | [Languages]
SiPinescript | Pinescript | [Languages]
SiPinetwork | Pinetwork | [Languages]
SiPingdom | Pingdom | [Frontend]
SiPinia | Pinia | [Other]
SiPino | Pino | [Other]
SiPinterest | Pinterest | [Languages]
SiPioneerdj | Pioneerdj | [Languages]
SiPiped | Piped | [Other]
SiPipx | Pipx | [Other]
SiPivotaltracker | Pivotaltracker | [Languages]
SiPiwigo | Piwigo | [Backend, Languages]
SiPix | Pix | [Other]
SiPixabay | Pixabay | [Other]
SiPixelfed | Pixelfed | [Other]
SiPixiv | Pixiv | [Other]
SiPixlr | Pixlr | [Languages]
SiPkgsrc | Pkgsrc | [Languages]
SiPlanet | Planet | [Other]
SiPlanetscale | Planetscale | [Database]
SiPlangrid | Plangrid | [Languages]
SiPlatformdotsh | Platformdotsh | [Languages]
SiPlatformio | Platformio | [Languages]
SiPlatzi | Platzi | [Other]
SiPlausibleanalytics | Plausibleanalytics | [Other]
SiPlaycanvas | Playcanvas | [Design]
SiPlayerdotme | Playerdotme | [Languages]
SiPlayerfm | Playerfm | [Languages]
SiPlaystation | Playstation | [Other]
SiPlaystation2 | Playstation2 | [Other]
SiPlaystation3 | Playstation3 | [Other]
SiPlaystation4 | Playstation4 | [Other]
SiPlaystation5 | Playstation5 | [Other]
SiPlaystationportable | Playstationportable | [Languages]
SiPlaystationvita | Playstationvita | [Other]
SiPleroma | Pleroma | [Languages]
SiPlesk | Plesk | [Other]
SiPlex | Plex | [Other]
SiPlotly | Plotly | [Other]
SiPlume | Plume | [Other]
SiPluralsight | Pluralsight | [Languages]
SiPlurk | Plurk | [Languages]
SiPm2 | Pm2 | [Other]
SiPnpm | Pnpm | [Other]
SiPocket | Pocket | [Other]
SiPocketbase | Pocketbase | [Backend]
SiPocketcasts | Pocketcasts | [Other]
SiPodcastaddict | Podcastaddict | [Other]
SiPodcastindex | Podcastindex | [Other]
SiPodman | Podman | [Other]
SiPoe | Poe | [Other]
SiPoetry | Poetry | [Languages]
SiPolars | Polars | [Languages]
SiPolestar | Polestar | [Languages]
SiPolkadot | Polkadot | [Other]
SiPoly | Poly | [Other]
SiPolygon | Polygon | [Backend, Languages]
SiPolymerproject | Polymerproject | [Languages]
SiPolywork | Polywork | [Languages]
SiPond5 | Pond5 | [Other]
SiPopos | Popos | [Other]
SiPorkbun | Porkbun | [Languages]
SiPorsche | Porsche | [Languages]
SiPortableappsdotcom | Portableappsdotcom | [Languages]
SiPortainer | Portainer | [Languages]
SiPortswigger | Portswigger | [Languages]
SiPosit | Posit | [Other]
SiPostcss | Postcss | [Frontend]
SiPostgresql | Postgresql | [Database, Languages]
SiPosthog | Posthog | [Other]
SiPostman | Postman | [Other]
SiPostmates | Postmates | [Other]
SiPowers | Powers | [Languages]
SiPrdotco | Prdotco | [Languages]
SiPreact | Preact | [Frontend, Languages]
SiPrecommit | Precommit | [Languages]
SiPrefect | Prefect | [Languages]
SiPremid | Premid | [Languages]
SiPremierleague | Premierleague | [Languages]
SiPrepbytes | Prepbytes | [Languages]
SiPrestashop | Prestashop | [Languages, Ecommerce]
SiPresto | Presto | [Languages]
SiPrettier | Prettier | [Frontend, Languages]
SiPretzel | Pretzel | [Languages]
SiPrevention | Prevention | [Languages]
SiPrezi | Prezi | [Languages]
SiPrimefaces | Primefaces | [Languages]
SiPrimeng | Primeng | [Languages]
SiPrimereact | Primereact | [Frontend, Languages]
SiPrimevue | Primevue | [Frontend, Languages]
SiPrintables | Printables | [Languages]
SiPrisma | Prisma | [Backend, Languages]
SiPrismic | Prismic | [Languages]
SiPrivatedivision | Privatedivision | [Languages]
SiPrivateinternetaccess | Privateinternetaccess | [Languages]
SiProbot | Probot | [Languages]
SiProcessingfoundation | Processingfoundation | [Frontend, Languages]
SiProcesson | Processon | [Languages]
SiProcesswire | Processwire | [Languages]
SiProducthunt | Producthunt | [Languages]
SiProgate | Progate | [Languages]
SiProgress | Progress | [Languages]
SiPrometheus | Prometheus | [DevOps, Languages]
SiPronounsdotpage | Pronounsdotpage | [Languages]
SiProsieben | Prosieben | [Languages]
SiProteus | Proteus | [Languages]
SiProtocolsdotio | Protocolsdotio | [Languages]
SiProtodotio | Protodotio | [Languages]
SiProton | Proton | [Languages]
SiProtoncalendar | Protoncalendar | [Languages]
SiProtondb | Protondb | [Languages]
SiProtondrive | Protondrive | [Languages]
SiProtonmail | Protonmail | [Languages]
SiProtonvpn | Protonvpn | [Languages]
SiProtools | Protools | [Languages]
SiProtractor | Protractor | [Languages]
SiProxmox | Proxmox | [Languages]
SiPterodactyl | Pterodactyl | [Languages]
SiPubg | Pubg | [Other]
SiPublons | Publons | [Other]
SiPubmed | Pubmed | [Other]
SiPug | Pug | [Other]
SiPulumi | Pulumi | [Other]
SiPuma | Puma | [Other]
SiPuppet | Puppet | [DevOps]
SiPuppeteer | Puppeteer | [DevOps, Languages]
SiPurescript | Purescript | [Languages]
SiPurgecss | Purgecss | [Frontend, Languages]
SiPurism | Purism | [Languages]
SiPushbullet | Pushbullet | [Other]
SiPusher | Pusher | [Languages]
SiPwa | Pwa | [Other]
SiPycharm | Pycharm | [Languages]
SiPycqa | Pycqa | [Other]
SiPydantic | Pydantic | [Other]
SiPyg | Pyg | [Other]
SiPypi | Pypi | [Other]
SiPypy | Pypy | [Other]
SiPyscaffold | Pyscaffold | [Other]
SiPysyft | Pysyft | [Other]
SiPytest | Pytest | [Other]
SiPython | Python | [Backend, Languages]
SiPythonanywhere | Pythonanywhere | [Backend, Languages]
SiPytorch | Pytorch | [Languages, AI]
SiPyup | Pyup | [Other]
SiQantas | Qantas | [Other]
SiQase | Qase | [Other]
SiQatarairways | Qatarairways | [Languages]
SiQbittorrent | Qbittorrent | [Languages]
SiQemu | Qemu | [Other]
SiQgis | Qgis | [Other]
SiQi | Qi | [Other]
SiQiita | Qiita | [Other]
SiQiskit | Qiskit | [Other]
SiQiwi | Qiwi | [Other]
SiQlik | Qlik | [Other]
SiQmk | Qmk | [Other]
SiQnap | Qnap | [Other]
SiQodo | Qodo | [Other]
SiQq | Qq | [Other]
SiQt | Qt | [Other]
SiQuad9 | Quad9 | [Other]
SiQualcomm | Qualcomm | [Other]
SiQualtrics | Qualtrics | [Languages]
SiQualys | Qualys | [Other]
SiQuantcast | Quantcast | [Other]
SiQuantconnect | Quantconnect | [Other]
SiQuarkus | Quarkus | [Languages]
SiQuarto | Quarto | [Languages]
SiQuasar | Quasar | [Languages]
SiQubesos | Qubesos | [Other]
SiQuest | Quest | [Other]
SiQuickbooks | Quickbooks | [Design]
SiQuicklook | Quicklook | [Design]
SiQuicktime | Quicktime | [Design]
SiQuicktype | Quicktype | [Design]
SiQuip | Quip | [Design]
SiQuizlet | Quizlet | [Design]
SiQuora | Quora | [Languages]
SiQwant | Qwant | [Other]
SiQwik | Qwik | [Frontend]
SiQwiklabs | Qwiklabs | [Frontend]
SiQzone | Qzone | [Other]
SiR | R | [Languages]
SiR3 | R3 | [Languages]
SiRabbitmq | Rabbitmq | [Backend, Languages]
SiRacket | Racket | [Languages]
SiRadar | Radar | [Languages]
SiRadarr | Radarr | [Languages]
SiRadiofrance | Radiofrance | [Languages]
SiRadixui | Radixui | [Frontend, Languages, Design]
SiRadstudio | Radstudio | [Languages]
SiRailway | Railway | [DevOps, Languages]
SiRainmeter | Rainmeter | [Languages]
SiRainyun | Rainyun | [Languages]
SiRakuten | Rakuten | [Languages]
SiRakutenkobo | Rakutenkobo | [Languages]
SiRam | Ram | [Languages]
SiRancher | Rancher | [Languages]
SiRapid | Rapid | [Languages]
SiRarible | Rarible | [Languages]
SiRasa | Rasa | [Languages]
SiRaspberrypi | Raspberrypi | [Backend, Languages]
SiRatatui | Ratatui | [Languages, Design]
SiRavelry | Ravelry | [Languages]
SiRay | Ray | [Languages]
SiRaycast | Raycast | [Languages]
SiRaylib | Raylib | [Languages]
SiRazer | Razer | [Languages]
SiRazorpay | Razorpay | [Languages]
SiRclone | Rclone | [Languages]
SiReact | React | [Frontend, Languages]
SiReactbootstrap | Reactbootstrap | [Frontend, Languages]
SiReacthookform | Reacthookform | [Frontend, Languages]
SiReactiveresume | Reactiveresume | [Frontend, Languages]
SiReactivex | Reactivex | [Frontend, Languages]
SiReactos | Reactos | [Frontend, Languages]
SiReactquery | Reactquery | [Frontend, Languages]
SiReactrouter | Reactrouter | [Frontend, Languages]
SiReacttable | Reacttable | [Frontend, Languages]
SiReaddotcv | Readdotcv | [Languages]
SiReadme | Readme | [Languages]
SiReadthedocs | Readthedocs | [Languages]
SiReason | Reason | [Languages]
SiReasonstudios | Reasonstudios | [Languages]
SiRecoil | Recoil | [Languages]
SiRed | Red | [Languages]
SiRedash | Redash | [Languages]
SiRedbubble | Redbubble | [Languages]
SiRedbull | Redbull | [Languages]
SiRedcandlegames | Redcandlegames | [Languages]
SiReddit | Reddit | [Languages]
SiRedhat | Redhat | [Languages]
SiRedhatopenshift | Redhatopenshift | [Languages]
SiRedis | Redis | [Backend, Database, Languages]
SiRedmine | Redmine | [Languages]
SiRedox | Redox | [Languages]
SiRedragon | Redragon | [Backend, Languages]
SiRedsys | Redsys | [Languages]
SiRedux | Redux | [Languages, Design]
SiReduxsaga | Reduxsaga | [Languages, Design]
SiRedwoodjs | Redwoodjs | [Languages]
SiReebok | Reebok | [Languages]
SiRefine | Refine | [Languages]
SiRefinedgithub | Refinedgithub | [DevOps, Languages]
SiRelay | Relay | [Languages]
SiRelianceindustrieslimited | Relianceindustrieslimited | [Languages]
SiRemark | Remark | [Languages]
SiRemedyentertainment | Remedyentertainment | [Languages]
SiRemix | Remix | [Frontend, Backend, Languages]
SiRemovedotbg | Removedotbg | [Languages]
SiRenault | Renault | [Languages]
SiRender | Render | [DevOps, Languages]
SiRenovate | Renovate | [Languages]
SiRenpy | Renpy | [Languages]
SiRenren | Renren | [Languages]
SiReplicate | Replicate | [Languages]
SiReplit | Replit | [Frontend, Languages]
SiRepublicofgamers | Republicofgamers | [Languages]
SiRescript | Rescript | [Languages]
SiRescuetime | Rescuetime | [Languages]
SiResearchgate | Researchgate | [DevOps, Languages]
SiResend | Resend | [Languages]
SiResharper | Resharper | [Languages]
SiResurrectionremixos | Resurrectionremixos | [Frontend, Backend, Languages]
SiRetool | Retool | [Languages]
SiRetroarch | Retroarch | [DevOps, Languages]
SiRetropie | Retropie | [Languages]
SiRevanced | Revanced | [Languages]
SiRevealdotjs | Revealdotjs | [Languages]
SiRevenuecat | Revenuecat | [Languages]
SiReverbnation | Reverbnation | [Languages]
SiRevoltdotchat | Revoltdotchat | [Languages]
SiRevolut | Revolut | [Languages]
SiRewe | Rewe | [Languages]
SiRezgo | Rezgo | [Backend, Languages]
SiRhinoceros | Rhinoceros | [Languages]
SiRich | Rich | [Languages]
SiRider | Rider | [Languages]
SiRimacautomobili | Rimacautomobili | [Languages]
SiRime | Rime | [Languages]
SiRing | Ring | [Languages]
SiRiotgames | Riotgames | [Languages]
SiRipple | Ripple | [Languages]
SiRiscv | Riscv | [Languages]
SiRiseup | Riseup | [Languages]
SiRitzcarlton | Ritzcarlton | [Languages]
SiRive | Rive | [Languages]
SiRoadmapdotsh | Roadmapdotsh | [Languages]
SiRoamresearch | Roamresearch | [DevOps, Languages]
SiRobinhood | Robinhood | [Languages]
SiRoblox | Roblox | [Languages]
SiRobloxstudio | Robloxstudio | [Languages]
SiRoboflow | Roboflow | [Languages]
SiRobotframework | Robotframework | [Languages]
SiRocket | Rocket | [Languages]
SiRocketdotchat | Rocketdotchat | [Languages]
SiRocksdb | Rocksdb | [Languages]
SiRockstargames | Rockstargames | [Languages]
SiRockwellautomation | Rockwellautomation | [Languages]
SiRockylinux | Rockylinux | [DevOps, Languages, Design]
SiRoku | Roku | [Languages]
SiRoll20 | Roll20 | [Languages]
SiRollbar | Rollbar | [Languages]
SiRolldown | Rolldown | [Languages]
SiRollsroyce | Rollsroyce | [Languages]
SiRollupdotjs | Rollupdotjs | [Frontend, Languages]
SiRook | Rook | [Languages]
SiRoon | Roon | [Languages]
SiRootme | Rootme | [Languages]
SiRoots | Roots | [Languages]
SiRootsbedrock | Rootsbedrock | [Languages]
SiRootssage | Rootssage | [Languages]
SiRos | Ros | [Languages]
SiRossmann | Rossmann | [Languages]
SiRotaryinternational | Rotaryinternational | [Languages]
SiRottentomatoes | Rottentomatoes | [Languages]
SiRoundcube | Roundcube | [Languages]
SiRsocket | Rsocket | [Languages]
SiRss | Rss | [Languages]
SiRstudioide | Rstudioide | [Languages]
SiRte | Rte | [Languages]
SiRtl | Rtl | [Languages]
SiRtlzwei | Rtlzwei | [Languages]
SiRtm | Rtm | [Languages]
SiRubocop | Rubocop | [Languages]
SiRuby | Ruby | [Languages]
SiRubygems | Rubygems | [Languages]
SiRubymine | Rubymine | [Languages]
SiRubyonrails | Rubyonrails | [Backend, Languages]
SiRubysinatra | Rubysinatra | [Languages]
SiRuff | Ruff | [Languages]
SiRumahweb | Rumahweb | [Languages]
SiRumble | Rumble | [Languages]
SiRundeck | Rundeck | [Languages]
SiRunkeeper | Runkeeper | [Languages]
SiRunkit | Runkit | [Languages]
SiRunrundotit | Runrundotit | [Languages]
SiRust | Rust | [Backend, Languages]
SiRustdesk | Rustdesk | [Backend, Languages]
SiRxdb | Rxdb | [Languages]
SiRyanair | Ryanair | [Languages]
SiRye | Rye | [Languages]
SiS7airlines | S7airlines | [Languages]
SiSabanci | Sabanci | [Other]
SiSafari | Safari | [Languages]
SiSage | Sage | [Other]
SiSagemath | Sagemath | [Other]
SiSahibinden | Sahibinden | [Other]
SiSailfishos | Sailfishos | [Other]
SiSailsdotjs | Sailsdotjs | [Other]
SiSalesforce | Salesforce | [Languages]
SiSalla | Salla | [Other]
SiSaltproject | Saltproject | [Languages]
SiSamsclub | Samsclub | [Other]
SiSamsung | Samsung | [Other]
SiSamsungpay | Samsungpay | [Other]
SiSanfranciscomunicipalrailway | Sanfranciscomunicipalrailway | [DevOps, Languages]
SiSanic | Sanic | [Other]
SiSanity | Sanity | [Other]
SiSaopaulometro | Saopaulometro | [Languages]
SiSap | Sap | [Other]
SiSartorius | Sartorius | [Languages]
SiSass | Sass | [Frontend]
SiSat1 | Sat1 | [Other]
SiSatellite | Satellite | [Frontend]
SiSaturn | Saturn | [Languages]
SiSaucelabs | Saucelabs | [Other]
SiSaudia | Saudia | [Other]
SiScala | Scala | [Languages]
SiScalar | Scalar | [Languages]
SiScaleway | Scaleway | [Other]
SiScania | Scania | [Other]
SiSchneiderelectric | Schneiderelectric | [Languages]
SiScikitlearn | Scikitlearn | [Languages, AI]
SiScilab | Scilab | [Other]
SiScipy | Scipy | [Other]
SiScopus | Scopus | [Other]
SiScpfoundation | Scpfoundation | [Frontend]
SiScrapbox | Scrapbox | [Languages]
SiScrapy | Scrapy | [Languages]
SiScratch | Scratch | [Languages]
SiScreencastify | Screencastify | [Languages]
SiScribd | Scribd | [Languages]
SiScrimba | Scrimba | [Languages]
SiScrollreveal | Scrollreveal | [Languages]
SiScrumalliance | Scrumalliance | [Languages]
SiScrutinizerci | Scrutinizerci | [Languages]
SiScylladb | Scylladb | [Other]
SiSeafile | Seafile | [Other]
SiSeagate | Seagate | [Other]
SiSearxng | Searxng | [Languages]
SiSeat | Seat | [Other]
SiSeatgeek | Seatgeek | [Other]
SiSecurityscorecard | Securityscorecard | [Languages]
SiSefaria | Sefaria | [Languages]
SiSega | Sega | [Other]
SiSelenium | Selenium | [Other]
SiSellfy | Sellfy | [Other]
SiSemanticrelease | Semanticrelease | [Languages]
SiSemanticscholar | Semanticscholar | [Languages]
SiSemanticui | Semanticui | [Design]
SiSemanticuireact | Semanticuireact | [Frontend, Languages, Design]
SiSemanticweb | Semanticweb | [Other]
SiSemaphoreci | Semaphoreci | [Languages]
SiSemrush | Semrush | [Languages]
SiSemver | Semver | [Languages]
SiSencha | Sencha | [Other]
SiSendgrid | Sendgrid | [Languages]
SiSennheiser | Sennheiser | [Languages]
SiSensu | Sensu | [Other]
SiSentry | Sentry | [Languages]
SiSepa | Sepa | [Other]
SiSequelize | Sequelize | [Backend]
SiServbay | Servbay | [Languages]
SiServerfault | Serverfault | [Languages]
SiServerless | Serverless | [Frontend, Languages]
SiSession | Session | [Other]
SiSessionize | Sessionize | [Other]
SiSetapp | Setapp | [Other]
SiSfml | Sfml | [Other]
SiShadcnui | Shadcnui | [Frontend, Design]
SiShadow | Shadow | [Other]
SiShanghaimetro | Shanghaimetro | [Languages]
SiSharex | Sharex | [Languages]
SiSharp | Sharp | [Languages]
SiShazam | Shazam | [Other]
SiShell | Shell | [Languages]
SiShelly | Shelly | [Languages]
SiShenzhenmetro | Shenzhenmetro | [Languages]
SiShieldsdotio | Shieldsdotio | [Other]
SiShikimori | Shikimori | [Languages]
SiShopee | Shopee | [Other]
SiShopify | Shopify | [Ecommerce]
SiShopware | Shopware | [Languages]
SiShortcut | Shortcut | [Languages]
SiShowpad | Showpad | [Other]
SiShowtime | Showtime | [Other]
SiShowwcase | Showwcase | [Other]
SiShutterstock | Shutterstock | [Languages]
SiSidekiq | Sidekiq | [Other]
SiSidequest | Sidequest | [Other]
SiSiemens | Siemens | [Other]
SiSifive | Sifive | [Other]
SiSignal | Signal | [Other]
SiSilverairways | Silverairways | [Languages]
SiSimilarweb | Similarweb | [Languages]
SiSimkl | Simkl | [Other]
SiSimpleanalytics | Simpleanalytics | [Other]
SiSimpleicons | Simpleicons | [Other]
SiSimplelocalize | Simplelocalize | [Other]
SiSimplelogin | Simplelogin | [Backend]
SiSimplenote | Simplenote | [Other]
SiSimplex | Simplex | [Other]
SiSinaweibo | Sinaweibo | [Other]
SiSingaporeairlines | Singaporeairlines | [Languages]
SiSinglestore | Singlestore | [Languages]
SiSitecore | Sitecore | [Languages]
SiSitepoint | Sitepoint | [Other]
SiSiyuan | Siyuan | [Other]
SiSkaffold | Skaffold | [Other]
SiSkeleton | Skeleton | [Other]
SiSketch | Sketch | [Design]
SiSketchfab | Sketchfab | [Design]
SiSketchup | Sketchup | [Design]
SiSkillshare | Skillshare | [Languages]
SiSkoda | Skoda | [Other]
SiSky | Sky | [Other]
SiSkypack | Skypack | [Other]
SiSlack | Slack | [Social]
SiSlackware | Slackware | [Languages, Social]
SiSlashdot | Slashdot | [Other]
SiSlickpic | Slickpic | [Other]
SiSlides | Slides | [Other]
SiSlideshare | Slideshare | [Languages]
SiSlint | Slint | [Other]
SiSmart | Smart | [Languages]
SiSmartthings | Smartthings | [Languages]
SiSmashingmagazine | Smashingmagazine | [Other]
SiSmoothcomp | Smoothcomp | [Other]
SiSmrt | Smrt | [Languages]
SiSmugmug | Smugmug | [Other]
SiSnapchat | Snapchat | [Other]
SiSnapcraft | Snapcraft | [Languages]
SiSnapdragon | Snapdragon | [Backend, Languages]
SiSncf | Sncf | [Other]
SiSnort | Snort | [Languages]
SiSnowflake | Snowflake | [Database]
SiSnowpack | Snowpack | [Other]
SiSnyk | Snyk | [Other]
SiSocialblade | Socialblade | [Other]
SiSociety6 | Society6 | [Other]
SiSocket | Socket | [Other]
SiSocketdotio | Socketdotio | [Other]
SiSoftcatala | Softcatala | [Other]
SiSoftpedia | Softpedia | [Other]
SiSogou | Sogou | [Backend, Languages]
SiSolana | Solana | [Other]
SiSolid | Solid | [Frontend]
SiSolidity | Solidity | [Frontend, Languages]
SiSololearn | Sololearn | [Languages]
SiSolus | Solus | [Other]
SiSonar | Sonar | [Languages]
SiSonarqubecloud | Sonarqubecloud | [Languages]
SiSonarqubeforide | Sonarqubeforide | [Languages]
SiSonarqubeserver | Sonarqubeserver | [Languages]
SiSonarr | Sonarr | [Languages]
SiSonatype | Sonatype | [Other]
SiSongkick | Songkick | [Other]
SiSongoda | Songoda | [Backend, Languages]
SiSonicwall | Sonicwall | [Other]
SiSonos | Sonos | [Other]
SiSony | Sony | [Other]
SiSoriana | Soriana | [Languages]
SiSoundcharts | Soundcharts | [Languages]
SiSoundcloud | Soundcloud | [Other]
SiSourceengine | Sourceengine | [Backend, Languages]
SiSourceforge | Sourceforge | [Languages]
SiSourcehut | Sourcehut | [Languages]
SiSourcetree | Sourcetree | [Languages]
SiSouthwestairlines | Southwestairlines | [Languages]
SiSpacemacs | Spacemacs | [Other]
SiSpaceship | Spaceship | [Other]
SiSpacex | Spacex | [Other]
SiSpacy | Spacy | [Other]
SiSparkar | Sparkar | [Languages]
SiSparkasse | Sparkasse | [Languages]
SiSparkfun | Sparkfun | [Languages]
SiSparkpost | Sparkpost | [Languages]
SiSpdx | Spdx | [Other]
SiSpeakerdeck | Speakerdeck | [Languages]
SiSpectrum | Spectrum | [Languages]
SiSpeedtest | Speedtest | [Other]
SiSpeedypage | Speedypage | [Other]
SiSphinx | Sphinx | [Other]
SiSpigotmc | Spigotmc | [Backend, Languages]
SiSpine | Spine | [Other]
SiSpinnaker | Spinnaker | [Languages]
SiSplunk | Splunk | [DevOps]
SiSpoj | Spoj | [Other]
SiSpond | Spond | [Other]
SiSpotify | Spotify | [Other]
SiSpotlight | Spotlight | [Other]
SiSpreadshirt | Spreadshirt | [Languages]
SiSpreaker | Spreaker | [Languages]
SiSpring | Spring | [Backend, Languages]
SiSpringboot | Springboot | [Backend, Languages]
SiSpringCreators | SpringCreators | [Backend, Languages]
SiSpringsecurity | Springsecurity | [Backend, Languages]
SiSpyderide | Spyderide | [Languages]
SiSqlalchemy | Sqlalchemy | [Database]
SiSqlite | Sqlite | [Frontend, Database]
SiSquare | Square | [Languages, Ecommerce]
SiSquareenix | Squareenix | [Languages, Ecommerce]
SiSquarespace | Squarespace | [Languages, Ecommerce]
SiSrgssr | Srgssr | [Languages]
SiSsrn | Ssrn | [Languages]
SiSst | Sst | [Other]
SiStackbit | Stackbit | [Other]
SiStackblitz | Stackblitz | [Frontend]
SiStackedit | Stackedit | [Other]
SiStackexchange | Stackexchange | [Other]
SiStackhawk | Stackhawk | [Other]
SiStackoverflow | Stackoverflow | [Languages]
SiStackshare | Stackshare | [Languages]
SiStadia | Stadia | [Other]
SiStaffbase | Staffbase | [Other]
SiStagetimer | Stagetimer | [Languages]
SiStandardjs | Standardjs | [Languages]
SiStandardresume | Standardresume | [Languages]
SiStarbucks | Starbucks | [Languages]
SiStardock | Stardock | [Languages]
SiStarlingbank | Starlingbank | [Languages]
SiStarship | Starship | [Languages]
SiStartdotgg | Startdotgg | [Languages]
SiStartpage | Startpage | [Languages]
SiStartrek | Startrek | [Languages]
SiStarz | Starz | [Languages]
SiStatamic | Statamic | [Other]
SiStatista | Statista | [Other]
SiStatuspage | Statuspage | [Other]
SiStatuspal | Statuspal | [Other]
SiSteam | Steam | [Other]
SiSteamdb | Steamdb | [Other]
SiSteamdeck | Steamdeck | [Other]
SiSteamworks | Steamworks | [Languages]
SiSteelseries | Steelseries | [Languages]
SiSteem | Steem | [Other]
SiSteemit | Steemit | [Other]
SiSteinberg | Steinberg | [Languages]
SiStellar | Stellar | [Languages]
SiStencil | Stencil | [Frontend]
SiStencyl | Stencyl | [Other]
SiStimulus | Stimulus | [Other]
SiStmicroelectronics | Stmicroelectronics | [Languages]
SiStockx | Stockx | [Other]
SiStopstalk | Stopstalk | [Other]
SiStoryblok | Storyblok | [Languages]
SiStorybook | Storybook | [Languages]
SiStrapi | Strapi | [Backend, Languages]
SiStrava | Strava | [Languages]
SiStreamlabs | Streamlabs | [Languages]
SiStreamlit | Streamlit | [Frontend, Languages]
SiStreamrunners | Streamrunners | [Languages]
SiStremio | Stremio | [Languages]
SiStripe | Stripe | [Languages, Ecommerce]
SiStrongswan | Strongswan | [Languages]
SiStryker | Stryker | [Languages]
SiStubhub | Stubhub | [Other]
SiStudio3t | Studio3t | [Other]
SiStyledcomponents | Styledcomponents | [Other]
SiStylelint | Stylelint | [Other]
SiStyleshare | Styleshare | [Languages]
SiStylus | Stylus | [Other]
SiSubaru | Subaru | [Languages]
SiSublimetext | Sublimetext | [Other]
SiSubstack | Substack | [Other]
SiSubtitleedit | Subtitleedit | [Other]
SiSubversion | Subversion | [Languages]
SiSuckless | Suckless | [Frontend]
SiSui | Sui | [Design]
SiSuitest | Suitest | [Design]
SiSumologic | Sumologic | [Other]
SiSuno | Suno | [Other]
SiSunrise | Sunrise | [Languages]
SiSupabase | Supabase | [Backend, Database]
SiSupercrease | Supercrease | [Languages]
SiSupermicro | Supermicro | [Languages]
SiSuperuser | Superuser | [Languages]
SiSurfshark | Surfshark | [Languages]
SiSurrealdb | Surrealdb | [Languages]
SiSurveymonkey | Surveymonkey | [Languages]
SiSuse | Suse | [Other]
SiSuzuki | Suzuki | [Other]
SiSvelte | Svelte | [Frontend]
SiSvg | Svg | [Design]
SiSvgdotjs | Svgdotjs | [Design]
SiSvgo | Svgo | [Backend, Languages, Design]
SiSvgtrace | Svgtrace | [Languages, Design]
SiSwagger | Swagger | [Languages]
SiSwarm | Swarm | [Languages]
SiSway | Sway | [Other]
SiSwc | Swc | [Other]
SiSwift | Swift | [Languages]
SiSwiggy | Swiggy | [Other]
SiSwiper | Swiper | [Languages]
SiSwisscows | Swisscows | [Other]
SiSwr | Swr | [Frontend, Languages]
SiSymantec | Symantec | [Other]
SiSymbolab | Symbolab | [Other]
SiSymfony | Symfony | [Backend]
SiSymphony | Symphony | [Other]
SiSympy | Sympy | [Other]
SiSyncthing | Syncthing | [Other]
SiSynology | Synology | [Other]
SiSystem76 | System76 | [Other]
SiTabelog | Tabelog | [Other]
SiTablecheck | Tablecheck | [Other]
SiTacobell | Tacobell | [Other]
SiTado | Tado | [Other]
SiTaichigraphics | Taichigraphics | [Languages]
SiTaichilang | Taichilang | [Other]
SiTails | Tails | [Other]
SiTailscale | Tailscale | [Other]
SiTailwindcss | Tailwindcss | [Frontend]
SiTaipy | Taipy | [Other]
SiTaketwointeractivesoftware | Taketwointeractivesoftware | [Languages]
SiTalend | Talend | [Other]
SiTalenthouse | Talenthouse | [Other]
SiTalos | Talos | [Other]
SiTamiya | Tamiya | [Other]
SiTampermonkey | Tampermonkey | [Languages]
SiTaobao | Taobao | [Other]
SiTapas | Tapas | [Other]
SiTarget | Target | [Languages]
SiTarom | Tarom | [Languages]
SiTask | Task | [Other]
SiTasmota | Tasmota | [Other]
SiTata | Tata | [Other]
SiTauri | Tauri | [Languages]
SiTaxbuzz | Taxbuzz | [Other]
SiTcs | Tcs | [Other]
SiTeal | Teal | [Other]
SiTeamcity | Teamcity | [Other]
SiTeamspeak | Teamspeak | [Social]
SiTeamviewer | Teamviewer | [Languages]
SiTechcrunch | Techcrunch | [Languages]
SiTed | Ted | [Other]
SiTeepublic | Teepublic | [Other]
SiTeespring | Teespring | [Backend, Languages]
SiTekton | Tekton | [Other]
SiTele5 | Tele5 | [Other]
SiTelefonica | Telefonica | [Other]
SiTelegram | Telegram | [Languages, Social]
SiTelegraph | Telegraph | [Languages]
SiTelenor | Telenor | [Languages]
SiTelequebec | Telequebec | [Other]
SiTemporal | Temporal | [Languages]
SiTensorflow | Tensorflow | [Languages, AI]
SiTeradata | Teradata | [Languages]
SiTeratail | Teratail | [Languages]
SiTermius | Termius | [Languages]
SiTerraform | Terraform | [DevOps, Languages]
SiTesco | Tesco | [Other]
SiTesla | Tesla | [Other]
SiTestcafe | Testcafe | [Other]
SiTestin | Testin | [Other]
SiTestinglibrary | Testinglibrary | [Languages]
SiTestrail | Testrail | [Languages]
SiTether | Tether | [Languages]
SiTextpattern | Textpattern | [Languages]
SiTga | Tga | [Other]
SiThangs | Thangs | [Other]
SiThanos | Thanos | [Other]
SiThealgorithms | Thealgorithms | [Backend, Languages]
SiTheboringcompany | Theboringcompany | [Languages]
SiTheconversation | Theconversation | [Languages]
SiThefinals | Thefinals | [Other]
SiTheguardian | Theguardian | [Languages]
SiTheirishtimes | Theirishtimes | [Languages]
SiThemighty | Themighty | [Other]
SiThemodelsresource | Themodelsresource | [Languages]
SiThemoviedatabase | Themoviedatabase | [Other]
SiThenorthface | Thenorthface | [Languages]
SiTheodinproject | Theodinproject | [Languages]
SiTheplanetarysociety | Theplanetarysociety | [Languages]
SiTheregister | Theregister | [Languages]
SiThesoundsresource | Thesoundsresource | [Languages]
SiThespritersresource | Thespritersresource | [Languages]
SiThestorygraph | Thestorygraph | [Languages]
SiThewashingtonpost | Thewashingtonpost | [Other]
SiTheweatherchannel | Theweatherchannel | [Languages]
SiThingiverse | Thingiverse | [Languages]
SiThinkpad | Thinkpad | [Other]
SiThirdweb | Thirdweb | [Languages]
SiThreadless | Threadless | [Frontend, Languages]
SiThreads | Threads | [Languages]
SiThreedotjs | Threedotjs | [Frontend, Languages]
SiThreema | Threema | [Frontend, Languages]
SiThumbtack | Thumbtack | [Other]
SiThunderbird | Thunderbird | [Languages]
SiThunderstore | Thunderstore | [Languages]
SiThurgauerkantonalbank | Thurgauerkantonalbank | [Languages]
SiThymeleaf | Thymeleaf | [Other]
SiTicketmaster | Ticketmaster | [Languages]
SiTicktick | Ticktick | [Other]
SiTidal | Tidal | [Other]
SiTiddlywiki | Tiddlywiki | [Other]
SiTide | Tide | [Other]
SiTidyverse | Tidyverse | [Languages]
SiTietoevry | Tietoevry | [Languages]
SiTiktok | Tiktok | [Social]
SiTildapublishing | Tildapublishing | [Other]
SiTile | Tile | [Other]
SiTimescale | Timescale | [Database]
SiTina | Tina | [Other]
SiTinder | Tinder | [Languages]
SiTindie | Tindie | [Other]
SiTinkercad | Tinkercad | [Languages]
SiTinygrad | Tinygrad | [Languages]
SiTinyletter | Tinyletter | [Languages]
SiTistory | Tistory | [Languages]
SiTldraw | Tldraw | [Languages]
SiTmux | Tmux | [Design]
SiTodoist | Todoist | [Other]
SiToggl | Toggl | [Other]
SiToggltrack | Toggltrack | [Languages]
SiTokio | Tokio | [Other]
SiTokyometro | Tokyometro | [Languages]
SiToll | Toll | [Other]
SiToml | Toml | [Other]
SiTomorrowland | Tomorrowland | [Languages]
SiTomtom | Tomtom | [Other]
SiTon | Ton | [Other]
SiTopcoder | Topcoder | [Languages]
SiTopdotgg | Topdotgg | [Other]
SiToptal | Toptal | [Other]
SiTorbrowser | Torbrowser | [Languages]
SiTorizon | Torizon | [Languages]
SiTorproject | Torproject | [Languages]
SiToshiba | Toshiba | [Other]
SiTotvs | Totvs | [Other]
SiTourbox | Tourbox | [Languages]
SiTower | Tower | [Languages]
SiToyota | Toyota | [Other]
SiTplink | Tplink | [Other]
SiTqdm | Tqdm | [Other]
SiTraccar | Traccar | [Languages]
SiTradingview | Tradingview | [Languages]
SiTraefikmesh | Traefikmesh | [Languages]
SiTraefikproxy | Traefikproxy | [Languages]
SiTrailforks | Trailforks | [Languages]
SiTrainerroad | Trainerroad | [Languages]
SiTrakt | Trakt | [Languages]
SiTransifex | Transifex | [Languages]
SiTransmission | Transmission | [Languages]
SiTransportforireland | Transportforireland | [Languages]
SiTransportforlondon | Transportforlondon | [Languages]
SiTravisci | Travisci | [DevOps, Languages]
SiTreehouse | Treehouse | [Languages]
SiTrello | Trello | [Languages]
SiTrendmicro | Trendmicro | [Languages]
SiTresorit | Tresorit | [Languages]
SiTreyarch | Treyarch | [DevOps, Languages]
SiTricentis | Tricentis | [Languages]
SiTrilium | Trilium | [Languages]
SiTriller | Triller | [Languages]
SiTrillertv | Trillertv | [Languages]
SiTrimble | Trimble | [Languages]
SiTrino | Trino | [Languages]
SiTripadvisor | Tripadvisor | [Languages]
SiTripdotcom | Tripdotcom | [Languages]
SiTrivago | Trivago | [Backend, Languages]
SiTrivy | Trivy | [Languages]
SiTrove | Trove | [Languages]
SiTrpc | Trpc | [Backend, Languages]
SiTruenas | Truenas | [Languages]
SiTrueup | Trueup | [Languages]
SiTrulia | Trulia | [Languages]
SiTrustedshops | Trustedshops | [Backend, Languages]
SiTrustpilot | Trustpilot | [Backend, Languages]
SiTryhackme | Tryhackme | [Languages]
SiTryitonline | Tryitonline | [Languages]
SiTsnode | Tsnode | [Backend]
SiTubi | Tubi | [Other]
SiTui | Tui | [Design]
SiTumblr | Tumblr | [Languages]
SiTunein | Tunein | [Other]
SiTurbo | Turbo | [Languages]
SiTurborepo | Turborepo | [Languages]
SiTurbosquid | Turbosquid | [Languages, Design]
SiTurkishairlines | Turkishairlines | [Languages]
SiTurso | Turso | [Database, Languages]
SiTuta | Tuta | [Other]
SiTuxedocomputers | Tuxedocomputers | [Languages, Design]
SiTv4play | Tv4play | [Other]
SiTvtime | Tvtime | [Other]
SiTwenty | Twenty | [Other]
SiTwilio | Twilio | [Other]
SiTwinkly | Twinkly | [Other]
SiTwinmotion | Twinmotion | [Other]
SiTwitch | Twitch | [Social]
SiTypeform | Typeform | [Languages]
SiTypeorm | Typeorm | [Backend, Languages]
SiTyper | Typer | [Languages]
SiTypescript | Typescript | [Frontend, Languages]
SiTypo3 | Typo3 | [Other]
SiTypst | Typst | [Other]
SiUber | Uber | [Languages]
SiUbereats | Ubereats | [Languages]
SiUbiquiti | Ubiquiti | [Design]
SiUbisoft | Ubisoft | [Other]
SiUblockorigin | Ublockorigin | [Backend, Languages]
SiUbuntu | Ubuntu | [DevOps]
SiUbuntumate | Ubuntumate | [DevOps]
SiUdacity | Udacity | [Other]
SiUdemy | Udemy | [Other]
SiUdotsdotnews | Udotsdotnews | [Other]
SiUfc | Ufc | [Other]
SiUikit | Uikit | [Design]
SiUipath | Uipath | [Design]
SiUkca | Ukca | [Other]
SiUltralytics | Ultralytics | [Languages]
SiUlule | Ulule | [Other]
SiUmami | Umami | [Other]
SiUmbraco | Umbraco | [Languages]
SiUmbrel | Umbrel | [Languages]
SiUml | Uml | [Other]
SiUnacademy | Unacademy | [Other]
SiUnderarmour | Underarmour | [Languages]
SiUnderscoredotjs | Underscoredotjs | [Languages]
SiUndertale | Undertale | [Languages]
SiUnicode | Unicode | [Other]
SiUnilever | Unilever | [Languages]
SiUniqlo | Uniqlo | [Other]
SiUniqloJa | UniqloJa | [Other]
SiUnitedairlines | Unitedairlines | [Languages]
SiUnitednations | Unitednations | [Other]
SiUnity | Unity | [Design]
SiUnjs | Unjs | [Other]
SiUnlicense | Unlicense | [Other]
SiUnocss | Unocss | [Frontend]
SiUnpkg | Unpkg | [Other]
SiUnraid | Unraid | [Languages]
SiUnrealengine | Unrealengine | [Backend, Languages, Design]
SiUnsplash | Unsplash | [Design]
SiUnstop | Unstop | [Other]
SiUntappd | Untappd | [Other]
SiUpcloud | Upcloud | [Other]
SiUphold | Uphold | [Other]
SiUplabs | Uplabs | [Other]
SiUpptime | Upptime | [Other]
SiUps | Ups | [Other]
SiUpstash | Upstash | [Other]
SiUptimekuma | Uptimekuma | [Other]
SiUpwork | Upwork | [Languages]
SiUservoice | Uservoice | [Languages]
SiUsps | Usps | [Other]
SiUtorrent | Utorrent | [Languages]
SiUv | Uv | [Other]
SiV | V | [Other]
SiV0 | V0 | [Other]
SiV2ex | V2ex | [Other]
SiV8 | V8 | [Other]
SiVaadin | Vaadin | [Other]
SiVagrant | Vagrant | [Languages]
SiVala | Vala | [Other]
SiValorant | Valorant | [Languages]
SiValve | Valve | [Other]
SiVanillaextract | Vanillaextract | [Languages]
SiVapor | Vapor | [Languages]
SiVault | Vault | [Other]
SiVaultwarden | Vaultwarden | [Languages]
SiVauxhall | Vauxhall | [Design]
SiVbulletin | Vbulletin | [Other]
SiVectary | Vectary | [Languages]
SiVectorlogozone | Vectorlogozone | [Backend, Languages]
SiVectorworks | Vectorworks | [Languages]
SiVeeam | Veeam | [Other]
SiVeed | Veed | [Other]
SiVeepee | Veepee | [Other]
SiVega | Vega | [Other]
SiVegas | Vegas | [Other]
SiVelocity | Velocity | [Other]
SiVelog | Velog | [Other]
SiVencord | Vencord | [Languages]
SiVenmo | Venmo | [Other]
SiVercel | Vercel | [DevOps, Languages]
SiVerdaccio | Verdaccio | [Languages]
SiVeritas | Veritas | [Languages]
SiVerizon | Verizon | [Languages]
SiVespa | Vespa | [Other]
SiVestel | Vestel | [Other]
SiVexxhost | Vexxhost | [Other]
SiVfairs | Vfairs | [Languages]
SiViadeo | Viadeo | [Other]
SiViaplay | Viaplay | [Other]
SiViber | Viber | [Languages]
SiViblo | Viblo | [Other]
SiVictoriametrics | Victoriametrics | [Languages]
SiVictronenergy | Victronenergy | [Languages]
SiVikunja | Vikunja | [Other]
SiVim | Vim | [Other]
SiVimeo | Vimeo | [Other]
SiVimeolivestream | Vimeolivestream | [Languages]
SiVinted | Vinted | [Other]
SiVirgin | Virgin | [Backend, Languages]
SiVirginatlantic | Virginatlantic | [Backend, Languages]
SiVirginmedia | Virginmedia | [Backend, Languages]
SiVirtualbox | Virtualbox | [Languages]
SiVirustotal | Virustotal | [Backend, Languages]
SiVisa | Visa | [Other]
SiVisualparadigm | Visualparadigm | [Languages]
SiVisx | Visx | [Other]
SiVite | Vite | [Frontend]
SiVitepress | Vitepress | [Frontend, Languages]
SiVitess | Vitess | [Frontend]
SiVitest | Vitest | [Frontend]
SiVivaldi | Vivaldi | [Other]
SiVivawallet | Vivawallet | [Other]
SiVivino | Vivino | [Other]
SiVivint | Vivint | [Other]
SiVivo | Vivo | [Other]
SiVk | Vk | [Other]
SiVlcmediaplayer | Vlcmediaplayer | [Languages]
SiVmware | Vmware | [Languages]
SiVodafone | Vodafone | [Other]
SiVoelkner | Voelkner | [DevOps, Languages]
SiVoidlinux | Voidlinux | [DevOps, Design]
SiVoipdotms | Voipdotms | [Other]
SiVolkswagen | Volkswagen | [Other]
SiVolvo | Volvo | [Other]
SiVonage | Vonage | [Other]
SiVorondesign | Vorondesign | [Languages]
SiVowpalwabbit | Vowpalwabbit | [Other]
SiVox | Vox | [Other]
SiVrchat | Vrchat | [Languages]
SiVsco | Vsco | [Other]
SiVscodium | Vscodium | [Other]
SiVtex | Vtex | [Ecommerce]
SiVuedotjs | Vuedotjs | [Frontend]
SiVuetify | Vuetify | [Frontend]
SiVueuse | Vueuse | [Frontend]
SiVulkan | Vulkan | [Other]
SiVultr | Vultr | [Languages]
SiVyond | Vyond | [Other]
SiW3schools | W3schools | [Other]
SiWacom | Wacom | [Other]
SiWagmi | Wagmi | [Other]
SiWagtail | Wagtail | [Other]
SiWails | Wails | [Other]
SiWakatime | Wakatime | [Other]
SiWalkman | Walkman | [Other]
SiWallabag | Wallabag | [Other]
SiWalletconnect | Walletconnect | [Other]
SiWalmart | Walmart | [Languages]
SiWantedly | Wantedly | [Other]
SiWappalyzer | Wappalyzer | [Languages]
SiWarnerbros | Warnerbros | [Languages]
SiWarp | Warp | [Languages]
SiWasabi | Wasabi | [Other]
SiWasmcloud | Wasmcloud | [Other]
SiWasmer | Wasmer | [Languages]
SiWatchtower | Watchtower | [Languages]
SiWattpad | Wattpad | [Other]
SiWayland | Wayland | [Other]
SiWaze | Waze | [Other]
SiWazirx | Wazirx | [Languages]
SiWearos | Wearos | [Languages]
SiWeasyl | Weasyl | [Other]
SiWeb3dotjs | Web3dotjs | [Other]
SiWebassembly | Webassembly | [Other]
SiWebauthn | Webauthn | [Other]
SiWebcomponentsdotorg | Webcomponentsdotorg | [Languages]
SiWebdotde | Webdotde | [Other]
SiWebdriverio | Webdriverio | [Languages]
SiWebex | Webex | [Other]
SiWebflow | Webflow | [Other]
SiWebgl | Webgl | [Frontend]
SiWebgpu | Webgpu | [Other]
SiWeblate | Weblate | [Other]
SiWebmin | Webmin | [Other]
SiWebmoney | Webmoney | [Other]
SiWebpack | Webpack | [Frontend]
SiWebrtc | Webrtc | [Languages]
SiWebstorm | Webstorm | [Languages]
SiWebtoon | Webtoon | [Other]
SiWebtrees | Webtrees | [Languages]
SiWechat | Wechat | [Other]
SiWegame | Wegame | [Other]
SiWeightsandbiases | Weightsandbiases | [Other]
SiWelcometothejungle | Welcometothejungle | [Other]
SiWellfound | Wellfound | [Other]
SiWellsfargo | Wellsfargo | [Backend, Languages]
SiWemo | Wemo | [Other]
SiWeread | Weread | [Languages]
SiWesterndigital | Westerndigital | [DevOps, Languages]
SiWesternunion | Westernunion | [Languages]
SiWetransfer | Wetransfer | [Languages]
SiWezterm | Wezterm | [Languages]
SiWgpu | Wgpu | [Other]
SiWhat3words | What3words | [Languages]
SiWhatsapp | Whatsapp | [Social]
SiWheniwork | Wheniwork | [Languages]
SiWikibooks | Wikibooks | [Other]
SiWikidata | Wikidata | [Other]
SiWikidotgg | Wikidotgg | [Other]
SiWikidotjs | Wikidotjs | [Other]
SiWikimediacommons | Wikimediacommons | [Other]
SiWikimediafoundation | Wikimediafoundation | [Frontend]
SiWikipedia | Wikipedia | [Other]
SiWikiquote | Wikiquote | [Other]
SiWikisource | Wikisource | [Languages]
SiWikiversity | Wikiversity | [Languages]
SiWikivoyage | Wikivoyage | [Other]
SiWinamp | Winamp | [Other]
SiWindsurf | Windsurf | [Languages]
SiWine | Wine | [Other]
SiWipro | Wipro | [Languages]
SiWire | Wire | [Languages]
SiWireguard | Wireguard | [Languages]
SiWireshark | Wireshark | [Languages]
SiWise | Wise | [Other]
SiWish | Wish | [Other]
SiWistia | Wistia | [Other]
SiWix | Wix | [Other]
SiWizzair | Wizzair | [Languages]
SiWolfram | Wolfram | [Languages]
SiWolframlanguage | Wolframlanguage | [Languages]
SiWolframmathematica | Wolframmathematica | [Languages]
SiWondershare | Wondershare | [Languages]
SiWondersharefilmora | Wondersharefilmora | [Languages]
SiWoo | Woo | [Other]
SiWoocommerce | Woocommerce | [Languages, Ecommerce]
SiWordpress | Wordpress | [Backend, Languages]
SiWorkplace | Workplace | [Languages]
SiWorldhealthorganization | Worldhealthorganization | [Languages]
SiWpengine | Wpengine | [Backend]
SiWpexplorer | Wpexplorer | [Languages]
SiWprocket | Wprocket | [Languages]
SiWritedotas | Writedotas | [Languages]
SiWwe | Wwe | [Other]
SiWwise | Wwise | [Other]
SiWxt | Wxt | [Other]
SiWykop | Wykop | [Other]
SiWyze | Wyze | [Other]
SiX | X | [Other]
SiXampp | Xampp | [Other]
SiXcode | Xcode | [Other]
SiXdadevelopers | Xdadevelopers | [Languages]
SiXdotorg | Xdotorg | [Languages]
SiXendit | Xendit | [Other]
SiXero | Xero | [Languages]
SiXfce | Xfce | [Other]
SiXiaohongshu | Xiaohongshu | [Other]
SiXiaomi | Xiaomi | [Other]
SiXing | Xing | [Other]
SiXml | Xml | [Other]
SiXmpp | Xmpp | [Other]
SiXo | Xo | [Other]
SiXrp | Xrp | [Languages]
SiXsplit | Xsplit | [Frontend]
SiXstate | Xstate | [Other]
SiXubuntu | Xubuntu | [DevOps]
SiXyflow | Xyflow | [Other]
SiYaak | Yaak | [Other]
SiYabai | Yabai | [Other]
SiYale | Yale | [Other]
SiYamahacorporation | Yamahacorporation | [Languages]
SiYamahamotorcorporation | Yamahamotorcorporation | [Languages]
SiYaml | Yaml | [Other]
SiYandexcloud | Yandexcloud | [Other]
SiYarn | Yarn | [Languages]
SiYcombinator | Ycombinator | [Languages]
SiYelp | Yelp | [Other]
SiYeti | Yeti | [Other]
SiYii | Yii | [Other]
SiYoast | Yoast | [Other]
SiYolo | Yolo | [Other]
SiYouhodler | Youhodler | [Languages]
SiYoutube | Youtube | [Social]
SiYoutubegaming | Youtubegaming | [Social]
SiYoutubekids | Youtubekids | [Social]
SiYoutubemusic | Youtubemusic | [Social]
SiYoutubeshorts | Youtubeshorts | [Languages, Social]
SiYoutubestudio | Youtubestudio | [Social]
SiYoutubetv | Youtubetv | [Social]
SiYr | Yr | [Languages]
SiYubico | Yubico | [Other]
SiYunohost | Yunohost | [Other]
SiZabka | Zabka | [Other]
SiZaim | Zaim | [Other]
SiZalando | Zalando | [Other]
SiZalo | Zalo | [Other]
SiZap | Zap | [Other]
SiZapier | Zapier | [Languages]
SiZara | Zara | [Languages]
SiZazzle | Zazzle | [Other]
SiZcash | Zcash | [Other]
SiZcool | Zcool | [Other]
SiZdf | Zdf | [Other]
SiZebpay | Zebpay | [Other]
SiZebratechnologies | Zebratechnologies | [Languages]
SiZedindustries | Zedindustries | [Languages]
SiZelle | Zelle | [Other]
SiZenbrowser | Zenbrowser | [Languages]
SiZend | Zend | [Other]
SiZendesk | Zendesk | [Other]
SiZenn | Zenn | [Other]
SiZenodo | Zenodo | [Other]
SiZensar | Zensar | [Languages]
SiZerodha | Zerodha | [Languages]
SiZerotier | Zerotier | [Languages]
SiZettlr | Zettlr | [Languages]
SiZhihu | Zhihu | [Other]
SiZig | Zig | [Other]
SiZigbee | Zigbee | [Other]
SiZigbee2mqtt | Zigbee2mqtt | [Other]
SiZiggo | Ziggo | [Backend, Languages]
SiZilch | Zilch | [Other]
SiZillow | Zillow | [Other]
SiZincsearch | Zincsearch | [DevOps, Languages]
SiZingat | Zingat | [Other]
SiZod | Zod | [Frontend]
SiZoho | Zoho | [Other]
SiZoiper | Zoiper | [Languages]
SiZola | Zola | [Other]
SiZomato | Zomato | [Other]
SiZoom | Zoom | [Social]
SiZorin | Zorin | [Languages]
SiZotero | Zotero | [Languages]
SiZsh | Zsh | [Other]
SiZulip | Zulip | [Other]
SiZyte | Zyte | [Other]